add_drv命令 – 添加一个新的设备驱动程序到系统中--->add_drv命令用于通知系统新安装的设备驱动程序。系统中的每个设备都有一个与之相关的名称。这个名称由设备的n […]
wodim命令 – 将数据写入光盘--->wodim命令的作用是可以将数据写入CD或DVD光盘介质。 wodim命令包含在cdrkit中，如果你在自己的 […]
cdrwtool命令 – 在CD-R CD-RW和DVD-R设备上执行操作--->cdwrtool命令的作用是可以在CD-R、CD-RW或DVD-R设备上执行相应的操作。 cdwrtool命令 […]
nproc命令 – 显示当前进程可用的CPU数量--->nproc命令来自英文词组“number of processing units available”的缩写， […]
chcpu命令 – 配置CPU--->chcpu命令的作用是可以修改CPU的状态。可以启用或禁用CPU，扫描新的CPU，将CPU调动从虚拟机管理程序 […]
lsscsi命令 – 列出SCSI设备及属性信息--->lsscsi命令来自英文词组“List SCSI”的缩写，其功能是用于列出SCSI设备及属性信息，SCSI全称 […]
cpuspeed命令 – 用户空间的CPU频率调节--->cpuspeed命令的作用是可以监控系统的空闲百分比，降低或提高CPU的时钟速度和电压。在空闲时功耗降至最低， […]
pccardctl命令 – PCMCIA卡控制工具--->pccardctl命令的作用是可以监视和控制PCMCIA插槽的状态。 PCMCIA是专门用在笔记本或PDA、数 […]
lspcmcia命令 – 显示扩展的PCMCIA调试信息--->lspcmcia命令的作用是可以显示扩展的PCMCIA调试信息，是pccardctl ls命令的别名。 pcc […]
mev命令 – 报告鼠标事件--->mev命令的作用是可以报告鼠标事件。 mev命令是gpm计划的一部分。mev命令将它获得的鼠标控制台事件显示到 […]
hcitool命令 – 蓝牙调试工具--->hcitool命令用于配置蓝牙连接，并向蓝牙设备发送一些特殊命令。如果没有给定命令，或者使用了选项-h，hci […]
hciconfig命令 – 配置蓝牙设备--->hciconfig命令来自英文词组“HCI config”的缩写，其功能是用于配置蓝牙设备参数信息。HCI全称 […]
esxcfg-addons命令 – 列出ESX主机所安装的Addons--->esxcfg命令集分为网络管理类、存储管理类、系统管理类等几种类型，esxcfg-addons列出ESX主机所 […]
lpmove命令 – 将某个任务移动到另外一台打印机--->lpmove命令属于CUPS打印命令系列。该命令可以将指定的作业或所有作业从源移动到目标。打印作业可以是作业I […]
rfkill命令 – 管理蓝牙和WIFI设备--->rfkill命令来自英文词组“radio frequency kill”的缩写，其功能是管理系统中的蓝牙和WI […]
raw命令 – 将原始字符设备绑定到块设备--->raw用于将 Linux 原始字符设备绑定到块设备。可以使用任何块设备：在绑定时，设备驱动程序甚至不必可访问（ […]
hwinfo命令 – 查询硬件信息--->hwinfo命令来自英文词组“Hardware Information”的缩写，其功能是用于查询硬件信息。这是 […]
lpinfo命令 – 显示可用的设备或驱动程序--->lpinfo命令可列出可用的打印设备和驱动。 其中需要注意的是，该命令参数很多，但是主要是-v和-m两个参数的 […]
esxcli命令 – 管理ESXi虚拟机系统--->esxcli命令来自英文词组“ESXI command-line interface”的缩写，其功能是用于管理 […]
acpid命令 – 电源高级接口配置--->acpid命令向用户空间程序通知ACPI事件， acpid应该在系统引导期间启动，并且默认情况下将作为后台进程 […]
lpc命令 – 打印机控制程序--->lpc命令是命令行方式打印机控制程序，有5个内置命令。 语法格式: lpc [参数] 常用参数: ?/help […]
lpadmin命令 – 配置打印机和类--->lpadmin命令用于配置CUPS套件中的打印机和类，也被用来设置打印服务器默认打印机。 语法格式: lpad […]
aumix命令 – 设置音效装置--->aumix命令用于设置音效装置。aumix(audio mixer)命令设置各项音效装置的信号强度以及指定播放 […]
rcconf命令 – Linux下运行等级服务配置工具--->rcconf命令是Debian Linux下的运行等级服务配置工具，用以设置在特定的运行等级下系统服务的启动配 […]
cupsdisable命令 – 停止指定的打印机--->cupsdisable命令用于停止指定的打印机。 使用cupsdisable命令停止打印机时，可以指定某个确定 […]
cupsenable命令 – 启动指定的打印机--->cupsenable命令用于启动指定的打印机。 使用cupsenable命令启动打印机的时候，可以指定某个确定 […]
dmidecode命令 – 获取有关硬件方面的信息--->dmidecode命令的作用是以一种可读的方式显示机器的DMI(Desktop Management Inte […]
accept命令 – 允许向目标打印机发送打印任务--->accept命令属于CUPS套件，用于指示打印系统接受发往指定目标打印机的打印任务。 语法格式: accept […]
reject命令 – 拒绝向目标打印机发送打印任务--->reject命令属于CUPS套件，用于指示打印系统拒绝发往指定目标打印机的打印任务。 语法格式: reject […]
clock命令 – 调整 RTC 时间--->clock命令的作用是调整 RTC 时间。RTC是电脑内建的硬件时间，执行这项指令可以显示现在时刻，调整硬件时 […]
cancel命令 – 取消已存在的打印任务--->cancel指令用来取消已经存在的打印任务。 语法格式：cancle [参数] [打印任务号] 常用参数： – […]
lsusb命令 – 显示USB设备列表--->lsusb命令用于显示本机的USB设备列表，以及USB设备的详细信息。 lsusb命令显示的USB设备信息来自 […]
setpci命令 – 配置PCI硬件设备参数--->setpci命令来自英文词组“Set PCI”的缩写，其功能是用于配置PCI硬件设备参数。setpci命令能够 […]
cdrecord命令 – 光盘刻录工具--->cdrecord命令用于Linux系统下光盘刻录，它支持CD和DVD格式。linux下一般都带有cdrecor […]
lspci命令 – 显示当前设备PCI总线设备信息--->lspci命令来自英文词组“list PCI”的缩写，其功能是用于显示当前设备PCI总线设备信息。 语法格式： […]
sensors命令 – 检测服务器硬件信息--->sensors命令用于检测服务器硬件信息，例如CPU电压与温度、主板、风扇转速等数据。 语法格式：sensor […]
lscpu命令 – 显示CPU架构信息--->lscpu命令来自英文词组“list the CPU architecture”的缩写，其功能是用于显示CPU […]
blockdev命令 – 调用区块设备控制程序--->实用程序blockdev允许从命令行调用block设备ioctl， 以实现对设备的控制 。 语法格式：bloc […]
mouseconfig命令 – 设置鼠标相关参数--->mouseconfig为鼠标设置程序，可自动设置相关参数，或者用户也可以利用所提供互动模式自行设置鼠标。mou […]
rdev命令 – 查询、设置内核映像文件--->rdev命令可以用来查询/设置内核映像文件的根设备，RAM 磁盘大小或视频模式。 不带任何参数的 rdev 命 […]
lp命令 – 打印文件或者修改排队的打印任务--->lp命令用于打印文件，或者修改排队的打印任务。与lpr命令类似，lp命令既支持文件输入也支持标准输入。它与lp […]
dumkeys命令 – 显示键盘映射表--->dumpkeys命令用于显示键盘映射表，输出的内容可以被loadkeys命令识别,改变映射关系.。loadke […]
loadkeys命令 – 改变linux键盘驱动程序--->loadkeys命令可以根据一个键盘定义表改变 linux 键盘驱动程序转译键盘输入过程。 语法格式：load […]
mount命令 – 将文件系统挂载到目录--->mount命令的功能是用于将文件系统挂载到目录，文件系统指的是被格式化过的硬盘或分区设备，进行挂载操作后，用户 […]
setleds命令 – 设置键盘的LED灯光状态--->setleds命令来自英文词组“Set leds”的拼写，其功能是用于设置键盘的LED灯光状态。这是个神奇的命 […]