blktrace命令 – 分析磁盘I/O负载情况--->blktrace命令来自英文词组“block trace”的缩写，其功能是用于分析磁盘I/O负载情况。查看Li […]
mkfs.ext4 命令 – 对磁盘设备进行Ext4格式化--->mkfs.ext4命令来自英文词组“make filesystem Ext4”的缩写，其功能是用于对磁盘设备进 […]
mkimage命令 – 制作可启动镜像文件--->mkimage命令来自英文词组“Make image”的缩写，其功能是用于制作可启动镜像文件。mkimage命 […]
iozone命令 – 测试磁盘性能--->iozone命令来自英文词组“I/O zone”的拼写，其功能是用于测试磁盘性能。iozone是一个文件系统的 […]
fio命令 – 对磁盘进行压力测试--->fio命令来自英文词组“Flexible IO Tester”的缩写，其功能是用于对磁盘进行压力测试。硬盘I/ […]
dmsetup命令 – 管理硬盘映射器--->dmsetup命令来自英文词组“Device mapper setup”的缩写，其功能是用于管理硬盘映射器。d […]
mdadm命令 – 管理RAID磁盘阵列组--->mdadm命令来自英文词组“multiple devices admin”的缩写，其功能是用于管理RAID磁盘 […]
lvchange命令 – 更改逻辑卷属性--->lvchange命令来自英文词组“LV change”的缩写，其功能是用于更改逻辑卷属性。LVM逻辑卷管理器是 […]
lvmconf命令 – LVM配置修改--->lvmconf命令的作用是可以修改在LVM配置文件中锁定的配置。 LVM全拼为Logical Volume M […]
lvmdump命令 – 转储LVM2有关的各种信息--->lvmdump命令的作用是可以用来转储LVM2有关的各种信息。 LVM2是在linux上提供逻辑卷管理功能的用 […]
lvmdiskscan命令 – 扫描可见LVM2所有设备--->lvmdiskscan命令的作用是可以在系统中为LVM物理卷扫描所有的SCSI、IDE磁盘、多种设备和其他块设 […]
lvmetad命令 – 启动LVM元数据高速缓存守护进程--->lvmetad命令的作用是启动LVM元数据缓存守护进程。 正常情况下，lvmetad命令通过处理来自客户端的提 […]
lvs命令 – 报告有关逻辑卷的信息--->lvs命令的作用是可以报告有关逻辑卷的信息。 逻辑卷建立在卷组之上，它是从卷组中“切出”的一块空间。它是最终用 […]
fsck.minix命令 – 文件系统管理--->Linux fsck.minix命令用于检查文件系统并尝试修复错误。 当minix文件系统发生错误时，可用fs […]
ext2ed命令 – 文件系统编辑程序--->ext2ed命令属于ext2文件系统编辑程序。 ext2ed可直接处理硬盘分区上的数据，这指令只有Red Ha […]
vgs命令 – 显示逻辑卷的卷组信息--->vgs命令来自英文词组“volume groups display”的缩写，其功能是用于显示逻辑卷的卷组信息。 […]
pvresize命令 – 调整LVM中物理卷的容量大小--->pvresize命令来自英文词组“Physical Volume resize”的缩写，其功能是用于调整LVM […]
vgsplit命令 – 将物理卷移动到新的或现有的卷组中--->vgsplit命令的作用是可以从源卷组（物理卷）移动到新的或现有的卷组中。 使用vgsplit命令将一个或多个 […]
warnquota命令 – 发送邮件给超出配额的用户--->warnquota命令的作用是可以对超过磁盘限额的用户发出警告邮件，而邮件的内容在/etc/warnquota […]
vgmerge命令 – 合并两个卷组--->vgmerge命令的作用是可以合并两个现有的卷组。 如果物理盘区大小相等，并且两个卷组的物理和逻辑卷摘要都符合 […]
vgimportclone命令 – 导入并重命名复制的卷组--->vgimportclone命令的作用是可以导入并重命名复制的卷组，这有点类硬件快照。 复制的卷组和物理卷在与原 […]
vgimport命令 – 导入卷组--->vgimport命令的作用是可以导入卷组。 从不同的系统移动导出物理卷之后，vgimport命令配合相应map […]
vgexport命令 – 导出卷组--->vgexport命令的作用是可以导出卷组。 vgexport命令允许设置系统未知的非活动卷组名称。 也可以将该 […]
vgcfgrestore命令 – 还原卷组描述符区域--->vgcfgrestore命令的作用是可以从一个文件备份中恢复卷组的元数据。可以附加相关参数来指定备份文件，如果 […]
vgcfgbackup命令 – 备份卷组描述符区域--->vgcfgbackup命令的作用是可以备份卷组的元数据。如果在命令行上没有指定任何卷组，将备份所有的卷组。在默 […]
pvmove命令 – 移动PV物理盘--->pvmove命令来自英文词组“move physical volume”的缩写，其功能是用于移动PV物理盘。p […]
testdisk命令 – 修复磁盘文件--->testdisk是一个强大的免费的跨平台的数据恢复工具，这款软件主要被设计用于恢复丢失的分区以及修复那些由于人 […]
fsadm命令 – 在设备上调整或检查文件系统--->fsadm命令的作用是在设备上调整或检查文件系统。fsadm命令使用相同的API对ext2，ext3，ext4 […]
mformat命令 – 格式化MS-DOS文件系统的磁盘--->mformat命令可以用于对MS-DOS文件系统的磁盘进行格式化，在已经做过低阶格式化的磁片上建立 DOS 档 […]
partx命令 – 显示内核磁盘上分区情况--->partx命令用来告诉内核当前磁盘的分区情况，对一个磁盘或者分区表类型，尝试解析分区表。可以增加或删除分区。但 […]
mpartition命令 – 建立或删除MS-DOS的分区--->在讲述该命令之前，首先需要明白目录和分区的概念和区别： Linux的分区是物理上的概念，从物理上将存储空间分开 […]
mlabel命令 – 设定磁盘的标签--->mlabel命令用于设定磁盘的标签 (Label)。 如果磁盘上设定过标签，mlabel 会将他显示给使用者。 […]
mdu命令 – 显示MS-DOS目录所占用的磁盘空间--->mdu命令用于显示MS-DOS目录所占用的磁盘空间，mdu为mstools工具指令，可显示MS-DOS文件系统 […]
quotastats命令 – 显示Linux系统当前的磁盘配额运行状态信息--->quotastats命令用于显示Linux系统当前的磁盘配额运行状态信息。 语法格式：quotastats 参 […]
quotaon命令 – 激活Linux内核中指定文件系统的磁盘配额功能--->quotaon命令用于激活Linux内核中指定文件系统的磁盘配额功能。执行quotaon指令可开启用户和群组的 […]
vgextend命令 – 扩展卷组设备--->vgextend命令来自英文词组“volume group extend”的缩写，其功能是用于扩展卷组设备。L […]
pvcreate命令 – 创建物理卷设备--->pvcreate命令的功能是用于创建物理卷设备。LVM逻辑卷管理器技术由物理卷、卷组和逻辑卷组成，其中pvcr […]
vgconvert命令 – 转换指定LVM卷组的元数据格式--->vgconvert命令用于转换指定LVM卷组的元数据格式，通常将“LVM1”格式的卷组转换为“LVM2”格式。 […]
pvscan命令 – 列出找到的物理卷--->pvscan命令会扫描系统中连接的所有硬盘，列出找到的物理卷列表。使用pvscan命令的-n选项可以显示硬盘中 […]
pvremove命令 – 删除物理卷--->pvremove命令用于删除一个存在的物理卷。使用pvremove指令删除物理卷时，它将LVM分区上的物理卷信 […]
vgchange命令 – 修改卷组属性--->vgchange命令用于修改卷组的属性，经常被用来设置卷组是处于活动状态或非活动状态。处于活动状态的卷组无法被 […]
lvcreate命令 – 创建逻辑卷设备--->lvcreate命令的功能是用于创建逻辑卷设备。LVM逻辑卷管理器技术由物理卷、卷组和逻辑卷组成，其中lvcr […]
lvextend命令 – 扩展逻辑卷设备--->lvextend命令来自英文词组“logical volume extend”的缩写，其功能是用于扩展逻辑卷设 […]
setquota命令 – 设置文件系统配额--->setquota是一个命令行配额编辑器，可以采用命令行的方式直接设置用户或用户组的配额限制。 若想禁用配额限制 […]
repquota命令 – 显示文件系统配额的汇总信息--->repquota用于显示指定文件系统的磁盘使用情况与配额设置的汇总信息，对于用户，显示当前创建的文件数量、存储 […]
vgremove命令 – 删除VG卷组设备--->vgremove命令来自英文词组“Volume group remove”的缩写，其功能是用于删除VG卷组设备 […]
pvs命令 – 格式化输出物理卷信息报表--->pvs命令用于格式化输出物理卷信息报表，使用pvs命令仅能得到物理卷的概要信息。 语法格式：pvs [参数]  […]
sgdisk命令  –  Linux和Unix的命令行GPT操纵器--->sgdisk是Linux下操作GPT分区的工具， sgdisk程序使用完全基于命令行的用户界面，使其适用于脚本 […]
vgcreate命令 – 创建卷组设备--->vgcreate命令的功能是用于创建卷组设备。LVM逻辑卷管理器技术由物理卷、卷组和逻辑卷组成，其中vgcre […]
vgdisplay命令 – 显示VG卷组信息--->vgdisplay命令来自英文词组“volume group display”的缩写，其功能是用于显示VG卷组 […]
convertquota命令 – 替换旧的磁盘额数据文件--->convertquota命令用于将老的磁盘额数据文件（“quota.user”和“quota.group”）转 […]
swapon命令 – 激活交换分区--->swapon命令来自英文词组“SWAP on”的拼写，其功能是用于激活交换分区。swapon命令用于激活Lin […]
lvdisplay命令 – 显示LVM逻辑卷属性--->lvdisplay命令用于显示LVM逻辑卷空间大小、读写状态和快照信息等属性。如果省略”逻辑卷&# […]
pvck命令 – 检测物理卷LVM元数据一致性--->pvck命令用来检测物理卷的LVM元数据的一致性。默认情况下，物理卷中的前4个扇区保存着LVM卷标。 语法格式 […]
pvchange命令 – 改变物理卷分配许可--->pvchange命令允许管理员改变物理卷的分配许可，如果物理卷出现故障，可以使用pvchange命令禁止分配物 […]
pvdisplay命令 – 显示物理卷属性--->pvdisplay命令用于显示物理卷的属性。显示的物理卷信息包括：物理卷名称、所属的卷组、物理卷大小、PE大小 […]
lvresize命令 – 调整LVM逻辑卷空间大小--->lvresize命令用于调整LVM逻辑卷的空间大小，可以增大空间和缩小空间。使用lvresize命令调整逻辑卷 […]
partprobe命令 – 重读分区表信息--->partprobe命令来自英文词组“partition probe”的缩写，其功能是用于重读分区表信息。将磁盘 […]
lvreduce命令 – 减少LVM逻辑卷所占空间大小--->lvreduce命令用于减少LVM逻辑卷占用的空间大小。使用lvreduce命令收缩逻辑卷的空间大小有可能会删 […]
gdisk命令 – 交互式管理GTP分区设备--->gdisk命令来自英文词组“GPT fdisk”的缩写，其功能是用于交互式管理GTP分区设备。gdisk是一个 […]
mkswap命令 – 建立和设置SWAP交换分区--->mkswap命令用于在一个文件或者设备上建立交换分区。在建立完之后要使用sawpon命令开始使用这个交换区。最 […]
mknod命令 –  创建字符及块设备文件--->mknod命令的功能是用于创建字符及块设备文件，Linux系统中的一切都是文件，在系统与设备通信之前，都会自动 […]
lvscan命令 – 扫描LVM逻辑卷--->lvscan命令用于扫描当前系统中存在的所有的LVM逻辑卷。使用lvscan指令可以发现系统中的所有逻辑卷，及 […]
eject命令 – 退出抽取式设备--->eject命令用于退出抽取式设备。若设备已挂入，则eject会先将该设备卸除再退出。 语法格式： eject  […]
fsconf命令 – 设置文件系统相关功能--->fsconf是Red Hat Linux发行版专门用来调整Linux各项设置的程序。 语法格式： fsconf […]
quotacheck命令 – 扫描获取磁盘信息--->quotacheck命令通过扫描指定的文件系统，获取磁盘的使用情况，创建、检查和修复磁盘配额（quota）文件 […]
badblocks命令 – 检查磁盘装置中损坏的区块--->badblocks就是一个检查磁盘装置中损坏区块的命令，执行该命令时只须指定所要检查的磁盘装置，及此装置的磁盘 […]
hdparm命令 – 显示与设定硬盘参数--->hdparm命令来自英文词组“hard disk parameters”的缩写，其功能是用于显示与设定硬盘参数 […]
fdformat命令 – 对指定的软碟机装置进行低阶格式化--->fdformat命令用于对指定的软碟机装置进行低阶格式化。 使用这个指令对软碟格式化的时候，最好指定像是下面的 […]
sfdisk命令 – 硬盘分区工具--->sfdisk命令的功能是用于硬盘分区工作，与fdisk命令非常相似。Linux系统管理员使用sfdisk命令能 […]
losetup命令 – 设置循环设备--->losetup命令用来设置循环设备，查看回环设备的状态。循环设备可把文件虚拟成区块设备，籍以模拟整个文件系统， […]
cfdisk命令 – 用于磁盘分区--->cfdisk是用来磁盘分区的程序，它十分类似DOS的fdisk，具有互动式操作界面而非传统fdisk的问答式界 […]
mkdosfs命令 – 建立DOS文件系统--->mkdosfs命令用于建立DOS文件系统。 语法格式： mkdosfs [参数] 常用参数： -c 建立档案系 […]
lndir命令 – 连接目录内容--->lndir命令的全称为“ link directory ”，该命令用于连接目录内容。 执行lndir […]
e2fsck命令 – 检查使用 Linux ext2档案系统的partition是否正常工作--->e2fsck命令用于检查使用 Linux ext2 档案系统的 partition 是否正常工作。 e2fsc […]
mkfs命令 – 对设备进行格式化文件系统操作--->mkfs命令来自英文词组“make file system”的缩写，其功能是用于对设备进行格式化文件系统操作。 […]
quotaoff命令 – 关闭磁盘空间限制--->quotaoff命令关闭磁盘空间限制。 执行quotaoff命令可关闭用户和群组的磁盘空间限制。磁盘配额服务( […]
edquota命令 – 编辑用户或群组的磁盘配额--->edquota预设会使用vi来编辑使用者或群组的磁盘配额设置 语法格式：edquota [参数] [用户或群组 […]
parted命令 – 磁盘分区工具--->parted命令来自英文单词，中文译为“分开”，其功能是用于磁盘分区。parted命令是由GNU组织开发的一款 […]
newgrp命令 – 登入另一个群组--->newgrp命令类的英文全称为“new group”,该命令类似login指令，当它是以相同的帐号，另一个群组 […]
quota命令 – 显示磁盘已使用的空间与限制--->quota命令用于显示磁盘已使用的空间与限制。执行quota命令可查询磁盘空间的限制，并得知已使用多少空间。  […]
mzip命令 – 控制磁盘驱动器--->mzip是Zip/Jaz磁盘驱动器控制命令。为mtools工具命令，可设置Zip或Jaz磁盘驱动区的保护模式以 […]
fdisk命令 – 管理磁盘分区--->fdisk命令来自英文词组“Partition table manipulator for Linux”的缩写 […]
free命令 – 显示系统内存使用量情况--->free命令的功能是显示系统内存使用量情况，包含物理和交换内存的总量、使用量和空闲量情况。 语法格式：free […]
arpd命令 – 收集arp信息--->arpd命令是用来收集免费arp信息的一个守护进程，它将收集到的信息保存在磁盘上或者在需要时，提供给内核用户用 […]
lsblk命令 – 查看系统的磁盘使用情况--->lsblk命令来自英文词组“list block devices”的缩写，其功能是用于查看系统的磁盘使用情况。 […]
sync命令 – 刷新文件系统缓冲区--->sync命令用于强制被改变的内容立刻写入磁盘，更新信息速度非常快， 在Linux/Unix系统中，在文件或数据 […]
df命令 – 显示磁盘空间使用量情况--->df命令来自英文词组“report file system disk space usage”的缩写，其功能是 […]