sdiff命令 – 以并排方式合并文件之间的差异--->sdiff命令来自英文词组“Side-by-side merge of file differences”的缩 […]
mkvcdfs命令 – 制作vcd文件--->mkvcdfs命令用来制作能刻录VCD的镜像文件。 需要有支持SCSI和”generic&#822 […]
cdparanoia命令 – 翻录CD文件--->cdparanoia命令用于翻录CD文件。 cdparanoia翻录工具通常被认为是可用于翻录CD的最佳工具。 […]
genisoimage命令 – 创建ISO镜像文件--->genisoimage命令来自英文词组“generate ISO image”的缩写，其功能是用于创建ISO镜 […]
cdrdao命令 – 刻录影像到光盘--->cdrdao命令用来刻录影像到光盘。用来向您的 CD-R或CD-RW写数据。 需要有支持SCSI和&#8221 […]
gedit命令 – GNOME桌面的文本编辑器--->gedit命令来自英文词组“GNOME text editor”的缩写，其功能是用于编辑文本信息，是GNOME […]
db_load命令 – 加密信息并生成数据库文件--->db_load命令来自英文词组“read and load data”的缩写，其功能是用于加密信息并生成数据库 […]
red命令 – 文本编辑工具--->red命令的功能是用于文本编辑工具，能够将文件内容读入编辑器缓存，对副本进行编辑操作后再写入回硬盘中。与vi/ […]
view命令 – 编辑文本文件--->view命令的功能是用于编辑文本文件。view实际并不是一个真实存在的命令文件，而是vi命令的别名命令，因此使 […]
vi命令 – 文本编辑器--->vi命令的功能是用于编辑文本内容，是Linux系统字符界面下最常用的文本编辑工具，能够编辑任何的ASCII格式 […]
make命令 –  编译内核或源码文件--->make命令的功能是用于编译内核或源码文件。make是GNU工程化编译工具，用于编译众多相互关联的源代码文件， […]
nano命令 – 字符终端文本编辑器--->nano是一款基于字符终端的文本编辑器工具，类似于DOS系统下的editor程序，比Linux系统中常用的vi […]
gawk命令 – 模式扫描与处理语言--->gawk是Unix中原始awk程序的GNU版本,强大之处在于可以写脚本来读取文本行的数据，然后处理并显示数据。 […]
column命令 – 格式化内容为多列格式--->column命令来自英文单词“列、柱子”，其功能是用于格式化内容为多列格式。处理对象可以是标准输入，亦可以为文 […]
crudini命令 – 配置ini格式文件--->crudini命令来自英文词组“Create read update delete ini”的缩写，中文译为“ […]
tput命令 – 初始化和操作会话--->tput命令将通过 terminfo 数据库对您的终端会话进行初始化和操作。通过使用 tput，您可以更改几项 […]
tempfile命令 – 临时文件命名--->有时候在写Shell脚本的时候需要一些临时存储数据的才做，最适合存储临时文件数据的位置就是/tmp，因为该目录 […]
head命令 – 显示文件开头的内容--->head命令的功能是显示文件开头的内容，默认为前10行。 语法格式：head [参数] 文件名 常用参数： – […]
rm命令 – 删除文件或目录--->rm命令来自英文单词“remove”的缩写，中文译为“消除”，其功能是用于删除文件或目录，一次可以删除多个文件 […]
tac命令 – 反向显示文件内容--->tac命令的功能是用于反向显示文件内容，即常见的查看文件内容命令cat的反写形式，非常有趣，好记。也就是说，当 […]
let命令 – 执行一个或多个表达式--->let命令是bash中用于计算的工具，用于执行一个或多个表达式，变量计算中不需要加上 $ 来表示变量。如果表达 […]
spell命令 – 建立拼写检查程序--->spell可从标准输入设备读取字符串，结束后显示拼错的词汇。 语法格式： spell [字符串] 参考实例 检 […]
ispell命令 – 用于拼写检查程序--->ispell预设会使用/usr/lib/ispell/english.hash字典文件来检查文本文件。若在检查 […]
mtype命令 – mtools工具--->mtype为mtools工具命令，模拟MS-DOS的type命令，可显示MS-DOS文件的内容。 语法格式：  […]
pico命令 – 编辑文字文件--->pico是个简单易用、以显示导向为主的文字编辑程序，它伴随着处理电子邮件和新闻组的程序pine而来。 语法格式 […]
fmt命令 – 编排文本文件--->fmt命令会从指定的文件里读取内容，将其依照指定格式重新编排后，输出到标准输出设备。若指定的文件名为&#822 […]
fold命令 – 限制文件列宽--->fold命令会从指定的文件里读取内容，将超过限定列宽的列加入增列字符后，输出到标准输出设备。若不指定任何文件名 […]
jed命令 – 编辑文本文件--->jed命令用于编辑文本文件。 jed是以Slang所写成的程序，适合用来编辑程序原始代码。 语法格式：jed  […]
rgrep命令 – 查找文件里符合条件的字符串--->rgrep命令的功能和grep命令类似，可查找内容包含指定的范本样式的文件，如果发现某文件的内容符合所指定的范 […]
ed命令 – 文本编辑--->ed是Linux中功能最简单的文本编辑程序，一次仅能编辑一行而非全屏幕方式的操作。 ed命令并不是一个常用的命 […]
sed命令 – 批量编辑文本文件--->sed命令来自英文词组“stream editor”的缩写，其功能是用于利用语法/脚本对文本文件进行批量的编辑 […]
csplit命令 – 分割文件--->csplit命令的英文全称是“context split”，该命令用于将一个大文件分割成小的碎片，并且将分割后 […]
col命令 – 用于过滤控制字符--->功能介绍： col命令的英文全称是“colation”，其中文释义就是“过滤”。该命令是一个标准输入文本过滤器 […]
comm命令 – 比较两个已排过序的文件--->comm命令会一列列地比较两个已排序文件的差异，并将其结果显示出来，如果没有指定任何参数，则会把结果分成3行显 […]
colrm命令 – 过滤指定列--->colrm命令的英文全称是“column remove”，即意为删除列，功能是从标准输入设备读取数据，转而输出 […]
join命令 – 连接两个文件--->join的连接操作简言之就是将两个具有相同域的纪录给挑选出来，再将这些纪录所有的域放到一行。 注意：join在 […]
paste命令 – 合并两个文件--->paste命令来自英文单词“粘贴”，其功能是用于合并两个文件。paste命令能够将两个文件以列对列的方式进行合 […]
tr命令 – 字符转换工具--->tr命令来自英文单词“transform”的缩写，中文译为“转换”，其功能是用于字符转换。tr命令是一款批量字 […]
uniq命令 – 去除文件中的重复内容行--->uniq命令来自英文单词unique的缩写，中文译为独特的、唯一的，其功能是用于去除文件中的重复内容行。uni […]
look命令 – 查询单词--->look指令用于英文单字的查询。您仅需给予它欲查询的字首字符串，它会显示所有开头字符串符合该条件的单字。 语法 […]
grep命令 – 强大的文本搜索工具--->grep来自英文词组“global search regular expression and print o […]
tail命令 – 查看文件尾部内容--->tail命令的功能是用于查看文件尾部内容，例如默认会在终端界面上显示出指定文件的末尾十行，如果指定了多个文件， […]
expr命令 – 字符串及整数计算器--->expr命令来自英文单词“expression”的缩写，中文译为“表达式”，其功能是用于字符串及整数计算。常被 […]
rmdir命令 – 删除空目录文件--->rmdir命令来自英文词组“remove directory”的缩写，其功能是用于删除空目录文件。rmdir命 […]
echo命令 – 输出字符串或提取后的变量值--->echo命令来自英文单词“回声”，其功能是用于在终端设备上输出指定字符串或变量提取后的值，能够给用户一些简单的 […]
cat命令 – 在终端设备上显示文件内容--->cat命令来自英文词组”concatenate files and print“的缩写，其功能是用于在终端设备 […]