vim命令 – 文本编辑器--->vim命令的功能是用于编辑文本内容，是Linux系统字符界面下最常用的文本编辑工具，能够编辑任何的ASCII格 […]
keytool命令 – 密钥和证书管理工具--->keytool命令的功能是用于管理密钥和证书文件。密钥就是用于加解密用的文件或字符串，可以使用keytool命 […]
rndc-confgen命令 – 密钥生成工具--->rndc-confgen命令的作用是可以为rndc生成配置文件。 rndc命令通过TCP连接与DNS服务器通信 […]
umount.nfs命令 – 卸载NFS文件系统--->umount.nfs命令来自英文词组“unmount NFS”的缩写，其功能是用于卸载NFS文件系统。NFS全 […]
createdb命令 – 创建PostgreSQL数据库--->createdb命令来自英文词组“create database”的缩写，其功能是用于创建PostgreSQL […]
vacuumdb命令 – 清理并优化PostgreSQL数据库--->vacuumdb命令的作用是可以清理并优化一个PostgreSQL数据库。 vacuumdb命令也将产生由Po […]
beadm命令 – 管理 ZFS 引导环境--->beadm命令是管理ZFS启动环境（BEs）的用户界面。此实用程序供希望在一个系统上管理多个 Oracle S […]
xxd命令 – 以十六进制形式显示文件内容--->xdd命令的功能是用于以十六进制形式显示文件内容，亦可以将十六进制内容转换回原始二进制的形式。 语法格式：xx […]
xwininfo命令 – 窗口信息实用程序--->xwininfo是一个显示windows信息的实用程序,根据选择的选项，将显示各种信息。如果未选择任何选项，则 […]
ntpq命令 – 查询NTP时间服务器信息--->ntpq命令来自英文词组“NTP query”的缩写，其功能是用于查询NTP时间服务器信息。 语法格式：ntp […]
bsdtar命令 – 读取和写入磁带存档文件--->bsdtar创建和操作流式档案文件， 这个实现可以从tar、pax、cpio、zip、jar、ar、xar、r […]
zipdetails命令 – 显示zip文件的内部结构--->zipdetails 命令将向你显示详细信息：有关压缩文件的详细信息，可能比你想象的要多得多。即使我们正在查看 […]
zipgrep命令 – 查找压缩包内指定的文件--->zipgrep命令的功能是用于查找压缩包内指定的文件，亦可以用于查看压缩包内指定文件的内容。如果压缩包被加密， […]
zipnote命令 – 显示压缩包注释内容--->zipnote 命令可用于从 zip 归档中提取注释或添加注释。要显示注释，只需在命令前面加上归档名称即可,如 […]
crlutil命令 – 列出、生成、修改或删除NSS安全数据库文件中的CRL--->crlutil命令列出、生成、修改或删除NSS安全数据库文件中的CRL，并列出、创建、修改或删除特定CRL中的 […]
named-checkconf命令 – named配置文件语法检查--->named-checkconf命令来自英文词组“named check config”的缩写，其功能是用于na […]
getfattr命令 – 获取文件系统扩展属性信息--->getfattr命令来自英文词组“get extended attributes of filesystem  […]
matchpathcon命令 – 查看文件默认安全上下文--->matchpathcon命令的作用是可以得到指定文件默认SELinux安全上下文。 相同的路径可以具有不同的安 […]
fixfiles命令 – 修复安全上下文--->fixfiles命令的作用是可以修改RPM数据包里的文件的安全上下文。RPM包安装的会根据rpm包内记录来生成 […]
rndc命令 – 控制DNS服务器的操作--->使用rndc命令可以控制DNS服务器的操作。如果运行rndc命令时没有使用任何选项或参数，那么该命令会显示受支 […]
cpupower命令 – 调整CPU主频参数--->cpupower命令的功能是用于调整CPU主频参数，Linux系统内核支持根据使用场景来通过调节CPU主频参数 […]
groff命令 – 编写手册页面--->groff 是一套用GNU 实现troff 的程序。它还包括一个脚本，用来模仿nroff 和其他roff 家族 […]
cdp命令 – 播放CD音乐--->cdp命令用于播放CD音乐。 声卡设置好了，可以在光驱中插入一张CD，用装载命令mount将光盘载入，然后输入 […]
cdplay命令 – CD播放工具--->cdplay命令用于CD播放工具。 cdplay命令实际上就是一款cd播放软件，比如CD PLAYER，就是我 […]
vcdtools命令 – 制作vcd影像--->vcdtools命令用于制作vcd光盘影像。 需要有支持SCSI和”generic”S […]
sz命令 – 基于ZModem协议下载文件到本地--->sz命令来自英文词组“send ZMODEM”的缩写，其功能是基于ZModem协议从远程服务器下载文件到本地。 […]
rz命令 – 基于ZModem协议上传文件到服务器--->rz命令来自英文词组“receive ZMODEM”的缩写，其功能是基于ZModem协议上传文件到服务器。当我 […]
namei命令 – 列出一个路径中所有的成分--->namei命令通常可以用在出现权限问题时，它可以用于任何 UNIX 文件，如符号链接、文件、目录等。使用nam […]
ebtables命令 – 网络数据包过滤的配置工具--->ebtables和iptables类似，都是Linux系统下网络数据包过滤的配置工具。既然称之为配置工具，就是 […]
fstrim命令 – 回收文件系统中未使用的块资源--->fstrim命令来自英文词组“filesystem trim”的缩写，其功能是回收文件系统中未使用的块资源。f […]
inncheck命令 – 检查语法--->inncheck会检查inn配置文件的语法是否正确，但不会实际修改这些配置文件。 INN文件是一个微焦点COB […]
getent命令 – 查看系统数据库中的记录信息--->getent命令来自英文词组“get entries”的缩写，其功能是用于查看系统数据库中的记录信息。即便这些 […]
vsish命令 – vsan命令行--->与vsish进行交互的方式有两种，您可以交互式地登录到VSI shell并执行ls，获取或设置操作，或者通过非 […]
esxcfg-firewall命令 – 防火墙设置--->esxcfg命令集分为网络管理类、存储管理类、系统管理类等几种类型，ESX Server防火墙使用内置的ipt […]
mkntfs命令 – 创建 NTFS 文件系统--->mkntfs用于在设备上（通常是磁盘分区或文件）创建 NTFS 文件系统。device操作数是对应于设备的特殊 […]
xfs_info命令 – 查看XFS类型设备详情--->xfs_info命令来自英文词组“XFS information”的缩写，其功能是用于查看XFS文件系统详情。 […]
isosize命令 – 输出iso9660文件系统的长度--->使用isosize命令可以输出包含指定文件的iso9660文件系统的长度。该文件可以是正常的文件或块设备（比如 […]
vmkfstools命令 – 虚拟磁盘管理工具--->vmkfstools命令来自英文词组“VMK filesystem tools”的缩写，其功能是用于管理虚拟磁 […]
mkfs.ext2命令 – 建立ext2文件系统--->mkfs.ext2命令与mke2fs命令功能相同。都是用来建立ext2文件系统。 Ext2文件系统使用以ino […]
mkfs.msdos命令 – 建立DOS文件系统--->mkfs.msdos命令用于建立DOS文件系统。与mkdosfs命令功能相同。 DOS时代中就有了“目录”一术 […]
mkfs.minix命令 – 建立Minix文件系统--->mkfs.minix命令用来建立Minix文件系统。 Minix文件系统（英语：MINIX file syst […]
grub-md5-crypt命令 – 对GRUB 的密码进行加密--->MD5，一种被广泛使用的密码散列函数，可以产生出一个128位的散列值（hash value），用于确保信息传输 […]
mount.nfs4命令 – 挂载NFSv4文件系统--->mount.nfs4命令来自英文词组“mount NFSv4”的缩写，其功能是用于挂载NFSv4文件系统。NF […]
rtacct命令 – 网络统计工具--->使用rtacct命令可以监视内核snmp计数器和网络接口统计数据，它是一种网络统计的工具。 语法格式：rtac […]
iwconfig命令 – 配置无线网络接口--->使用iwconfig命令可以为无线接口显示或设置网络接口的参数，它可以用来配置无线网络接口是非常好用的。 语法 […]
mailx命令 – 发送和接收电子邮件--->mailx命令的功能是用于发送和接收电子邮件，拥有比mail命令更易读的邮件格式，应用于RHEL / Cent […]
vncviewer命令 – 连接VNC服务器--->vncviewer命令来自英文词组“VNC viewer”的拼写，中文译为“VNC查看器”，其功能是用于连接V […]
smbget命令 – 下载samba共享资源--->smbget命令来自英文词组“Samba get”的缩写，其功能是用于下载samba共享资源。smbget命令 […]
mount.nfs命令 – 挂载NFS网络文件系统--->mount.nfs命令来自英文词组“mount network file system”的缩写，其功能是用于挂 […]
svn命令 – subversion命令行客户端程序--->svn命令是subversion命令行客户端程序，大都数的子命令可接受文件或目录参数，对目录进行递归处理。如果 […]
nntptest命令 – 交互式NNTP测试程序--->使用nntptest命令可以进行交互式NNTP测试。它允许验证到一个NNTP服务器和交互式发出命令给它。一旦通 […]
mysqld_safe命令 – MySQL服务器启动脚本--->使用mysqld_safe命令可以启动MySQL服务器。mysqld_safe增加了一些安全功能，比如发生错误 […]
arptables-save命令 – 保存ARP表--->使用arptables-save命令可以转储ARP表中的内容，已便于以解析的格式输出到标准输出中。 语法格式： […]
zegrep命令 – 文件字符串过滤--->zegrep命令是一个文件字符串过滤工具，可以使用zegrep在压缩文件中多次搜索相对应的文件名与内容。 语法 […]
zipcloak命令 – 压缩文件加密--->zipcloak 命令对一个 zip 文件进行加密，提示你输入两次密码（以确保你不会“胖手指”），然后将该文件 […]
xsetwacom命令 – 查询和修改wacom驱动程序设置--->xsetwacom命令是用来查询或更改wacom驱动程序加载的设备上的属性，属性的修改在运行时发生，并且在X服 […]
pg_ctl命令 – 控制PostgreSQL服务--->pg_ctl是一个启动、停止、重新启动、重新加载配置文件、报告PostgreSQL服务器的状态，或者是杀掉Po […]
initdb命令 – 初始化数据库--->initdb命令来自英文词组“initialization database”的缩写，其功能是用于初始化数据库 […]
mysqlhotcopy命令 – 备份数据库--->使用mysqlhotcopy命令可以进行Mysql数据库备份，它使用FLUSH TABLES、LOCK TAB […]
mysqlbinlog命令 – 查看二进制日志文件--->使用mysqlbinlog命令可以查看二进制日志文件，该日志文件里面记录着所有的的DDL和DML语句。 语法格 […]
mysqlcheck命令 – 检查和修复MyISAM表--->使用mysqlcheck命令可以检查和修复MyISAM表。它可以优化和分析表。mysqlcheck的功能类似m […]
myisamchk命令 – 检查和修复MyISAM表--->使用myisamchk命令可以检查和修复MyISAM表。使用不带选项的命令，所有表将被检查是否有错误。 语法格 […]
mysql_install_db命令 – 初始化MySQL数据目录--->使用mysql_install_db命令可以初始化MySQL数据目录，并创建系统表。 语法格式：mysql_i […]
extundelete命令 – 文件恢复工具--->extundelete命令的功能是用于文件恢复。extundelete命令能够恢复分区中被意外删除的文件，在使 […]
grub-install命令 – 在设备上安装GRUB服务--->grub-install命令来自英文词组“GRand Unified Bootloader install”的 […]
7z命令 – 文件解压缩命令--->7z命令来自英文词组“7-zip”的缩写，其功能是用于文件解压缩工作。7-zip应该是Linux系统中常用的解 […]
ll命令 – 显示指定文件的详细属性信息--->ll命令的功能是显示指定文件或目录的详细属性信息，实际它不是一个真实存在的命令文件，而是“ls -l –co […]
mysqldumpslow命令 – 显示慢查询日志文件摘要--->使用mysqldumpslow命令可以解析慢查询日志文件，并显示其内容摘要。慢查询日志包含有关需要很长的时间来 […]
psql命令 – PostgreSQL交互式客户端工具--->psql是PostgreSQL的交互式客户端工具，通过该工具来管理和操作PostgreSQL数据库。 语法格式 […]
chacl命令 – 更改文件或目录的ACL--->chacl命令的作用是用来更改文件或目录的访问控制列表。chacl命令和chmod有异曲同工之妙。但是chac […]
getfacl命令 – 显示文件或目录的ACL策略--->getfacl命令来自英文词组“get file access control list”的缩写，其功能是用于 […]
aptitude命令 – 管理APT软件包--->aptitude命令的功能是用于管理APT软件包，是Debian Linux及其衍生系统中功能强大的包管理工具 […]
mdeltree命令 – 删除 MSDOS 格式文档及目录--->mdeltree命令会将所指定的目录与目录之下的所有档案与目录都删除掉。如果所指定的档案或目录不存在，则会传回 […]
return命令 – 从函数中退出并返回数值--->return命令的作用是使得shell函数退出并返回数值，如果没有指定n的值，则默认为函数最后一条命令执行的返 […]
yum命令 –  基于RPM的软件包管理器--->yum命令来自英文词组“YellowdogUpdater Modified”的缩写，其功能是用于在Linux系 […]
true命令 – 重定向清空文件内容--->true命令的功能是用于重定向清空文件内容，相当于使用echo命令输出重定向空白信息到指定文件的效果。true […]
tar命令 – 压缩和解压缩文件--->tar命令的功能是用于压缩和解压缩文件，能够制作出Linux系统中常见的.tar、.tar.gz、.tar.b […]
man命令 – 查看帮助信息--->man命令来自英文单词“manual”的缩写，中文译为“帮助手册”，其功能是用于查看命令、配置文件及服务的帮助 […]
inotifywatch命令 – 收集文件系统的统计数据--->inotifywatch命令来自于英文词组”inotify watch“的拼写，其功能是用于收集文件系统的统计 […]
inotifywait命令 – 异步文件系统监控--->inotifywait命令作用是用来收集有关文件访问信息。 linux发行版一般没有包括这个命令，需要安装in […]
hexdump – 以多种进制格式查看文件内容--->hexdump命令来自英文词组“Hexadecimal dump”的缩写，其功能是以多种进制格式查看文件内容。 […]
ltrace命令 – 跟踪进程调用库函数的情况--->ltrace命令是用来跟踪进程调用库函数的情况，ltrace其实也是基于ptrace。我们知道，ptrace能 […]
nm命令 – 显示二进制目标文件的符号表--->nm是names的缩写， nm命令主要是用来列出某些文件中的符号（说白了就是一些函数和全局变量等）。 一般来说 […]
readonly命令 – 标记shell变量或函数为只读--->readonly命令主要用于定义一到多个变量并设置只读属性, 为已定义的一到多个变量设置只读属性, 显示全部包 […]
readelf命令 – 显示elf格式文件的信息--->readelf命令用来显示一个或者多个elf格式的目标文件的信息，可以通过它的选项来控制显示哪些信息。这里的e […]
aureport命令 – 生成审计信息报表--->使用aureport命令可以生成审计信息的报表，必须以root用户执行。如果执行aureport命令时没有使用 […]
ausearch命令 – 检索审计记录--->ausearch命令来自英文词组“audit search”的缩写，其功能是用于检索审计记录。aus […]
auditctl命令 – 管理内核的审计系统--->auditctl命令来自英文词组“audit contol”的缩写，其功能是用于管理内核的审计系统。系统管理员 […]
autrace命令 – 跟踪指定进程--->使用autrace命令可以跟踪指定进程，并将跟踪的结果写入日志文件之中。 语法格式：autrace [参数]  […]
audit-viewer命令 – 查看和总结审计事件的图形工具--->使用audit-viewer命令可以查看和总结审计事件。 语法格式：audit-viewer 参考实例 打开审 […]
udevadm info命令 – 查询udev数据库中的设备信息--->使用udevadm info命令可以查询udev数据库中的设备信息。也可以从sysfs文件系统中查询到设备的属 […]
lpstat命令 – 显示cpus状态信息--->使用lpstat命令可以显示有关当前类、作业和打印机的状态信息。当不带参数运行时，将列出当前用户的作业队列。  […]
cupsaccept命令 – 接受作业发送到目的地--->使用cupsaccept命令可以指示打印系统接受打印作业到指定的目的地。 语法格式：cupsaccept [参 […]
cupsreject命令 – 拒绝作业发送到目的地--->使用cupsreject命令可以指示打印系统拒绝打印作业发送到指定的目的地。 语法格式：cupsreject  […]
rpmsign命令 – 签名管理工具--->rpmsign命令属于使用rpm软件包的签名管理工具。 语法格式：rpmsign [参数] 常用参数： –a […]
rpmquery命令 – 查询信息--->rpmquery命令使用多种依据从rpm数据库中查询软件包信息。 语法格式：rpmquery [参数] 常用参 […]
rpmbuild命令 – 创建软件包--->rpmbuild命令被用于创建rpm的二进制软件包和源码软件包。 语法格式：rpmbuild [参数] 常用参 […]
rpmdb命令 – 初始化和重建数据库--->rpmdb命令用于初始化和重建rpm数据库。 语法格式：rpmdb [参数] 常用参数： initdb 初始化 […]
rpm2cpio命令 – 文件格式转换--->rpm2cpio命令用于将rpm软件包转换为cpio格式的文件。 语法格式：rpm2cpio [参数] 常用参 […]
pfctl命令 – 配置防火墙策略--->pfctl命令来自英文词组“Packet Filter”的缩写，其功能是用于配置防火墙策略。Packet Fi […]
ngrep命令 – 数据包匹配和显示工具--->ngrep命令是grep命令的网络版，他力求更多的grep特征，用于搜寻指定的数据包。正由于安装ngrep需用 […]
git命令 – 管理分布式版本控制系统--->git命令的功能是用于管理分布式版本控制系统，是著名的Git版本控制系统的客户端，能够敏捷高效地处理任何或大或 […]
emacs命令 – 功能强大的文本编辑器--->emacs命令是由GNU组织的创始人Richard Stallman开发的一个功能强大的全屏文本编辑器，它支持 […]
egrep命令 – 在文件内查找指定的字符串--->egrep命令来自英文词组“extended Global Regular Expression Print” […]
fgrep命令 – 为文件搜索文字字符串--->fgrep命令的作用是用来搜索file参数指定的输入文件（缺省为标准输入）中的匹配模式的行。fgrep 命令特 […]
la命令 – 显示目录下所有文件--->la命令来自英文词组“list all”的缩写，其功能是用于显示指定目录下的所有文件信息。la命令的作用等同于 […]
sudoedit命令 – 以另外一个用户文件编辑文件--->使用sudoedit命令可以以另外一个用户身份编辑文件。 语法格式：sudoedit [参数] [文件] 常用 […]
visudo命令 – 编辑/etc/sudoers文件--->使用visudo命令可以打开/etc/sudoers文件进行编辑设置sudo 语法格式：visudo [参数] […]
vipw命令 – 编辑某些配置文件--->使用vipw命令可以编辑/etc/passwd、/etc/shadow、/etc/group和/etc/gsh […]
userpasswd命令 – 允许用户更改密码的图形化工具--->使用userpasswd命令可以允许用户轻松地更改自己的密码，它是一个图形化的工具。 语法格式： userpa […]
userinfo命令 – 更改自己的finger信息--->使用userinfo命令可以允许用户方便地更改自己的finger信息，这是一个图形化工具。 语法格式: use […]
groupmems命令 – 管理用户主要组群的成员--->使用groupmems命令可以管理用户主要组群的成员。 语法格式：groupmems [参数] 常用参数： – […]
autoupdate命令 – 更新configure.in到较新的Autoconf--->使用autoupdate命令可以更新configure.ac或configure.in到较新的Autoconf […]
perl命令 – 实用报表提取语言--->使用perl命令可以扫描任意文本文件，从这些文本文件中提取信息优化的语言，根据这些信息打印报告。 语法格式：  […]
find2perl命令 – 转换找到的命令行为perl代码--->使用find2perl命令可以找到命令行并转换为等效的Perl代码。 语法格式：find2perl [参数]  […]
zmore命令 – 查看压缩文件--->使用zmore命令可以查看gzip、zip、compress压缩文件。 语法格式：zmore [文件名] 参考 […]
zless命令 – 查看zip压缩文件--->使用zless命令可以查看zip压缩文件 语法格式：zless [文件名] 参考实例 查看zip压缩文件/ro […]
xzcmp命令 – 比较xz压缩文件--->使用xzcmp命令可以调用cmp程序比较xz压缩文件 语法格式：xzcmp [参数] [文件1] [文件2]  […]
xzdiff命令 – 比较xz压缩文件--->使用xzdiff命令可以调用diff程序比较xz压缩文件 语法格式：xzdiff [参数] [文件1] [文件 […]
xzdec命令 – 解压缩xz文件--->使用xzdec命令可以进行liblzma为基础的xz文件解压缩 语法格式：xzdec [参数] [文件] 常用 […]
xzgrep命令 – 在xz压缩文件上搜索正则表达式--->使用xzgrep命令可以在xz、gzip或bzip2压缩文件上启动grep搜索正则表达式。 语法格式：xzgr […]
uncompress命令 – 压缩或解压缩compress文件--->使用uncompres命令可以压缩或解压缩compress文件。其实uncompres命令是compress命 […]
xzless命令 – 查看xz压缩文本文件--->使用xzless命令可以查看xz压缩文本文件。 语法格式：xzless [文件] 参考实例 查看/root/a […]
xzmore命令 – 查看xz压缩文本文件--->使用xzmore命令可以查看xz压缩文本文件。 语法格式：xzmore [文件名] 参考实例 查看/root/ […]
tgz命令 – 将文件压缩为.tgz格式文件--->tgz命令来自英文词组“tape archive gunzip”的缩写，其功能适用于将文件压缩为.tgz格式文 […]
bzgrep命令 – 搜索.bz2压缩包中文件内容--->bzgrep命令使用正则表达式搜索“.bz2”压缩包中文件，将匹配的行显示到标注输出。 bzgrep命令本身没 […]
bzdiff命令 – 比较两个.bz2压缩包中文件的不同--->bzdiff命令用于直接比较两个“.bz2”压缩包中文件的不同，省去了解压缩后再调用diff命令的过程。 bz […]
bzcmp命令 – 比较.bz2压缩包中的文件--->bzcmp命令主要功能是在不真正解压缩.bz2压缩包的情况下，比较两个压缩包中的文件，省去了解压缩后在调用cm […]
pushd命令 – 添加目录到目录堆栈顶部--->pushd命令用于更改新目录并（或）压栈，或者把栈里的某个目录推到栈顶。 语法格式: pushd [参数] 常 […]
pssh命令 – 批量管理执行--->pssh是一款开源的软件，使用python实现，用于批量ssh操作大批量机器；pssh是一个可以在多台服务器上 […]
arj命令 – 创建和管理.arj压缩包--->arj命令是“.arj”格式的压缩文件的管理器，用于创建和管理“.arj”压缩包。 当创建arj压缩包时，可省 […]
gdbserver – 调试远程服务器--->使用gdbserver命令可以允许在不同的主机上运行GDB来进行程序调试。 语法格式：gdbserver [参 […]
lnewusers命令 – 创建用户账号--->使用lnewusers命令可以通过从标准输入中读取数据来创建用户账号。输入的数据每行有7个冒号分隔的字段，需要 […]
autoheader命令 – 创建C定义的模板文件--->使用autoheader命令可以为使用configure创建C定义的模板文件。在结尾处扫描模板文件，或conf […]
autoscan命令 – 生成一个初步的configure.in--->语法格式：autoscan [参数] [源目录] 常用参数： -v 冗长的报告处理 -d 不删除临时文件 参考 […]
autoconf命令 –  自动生成配置脚本--->使用autoconf命令可以从模板文件中生成一个配置脚本 语法格式：autoconf [参数] [模板文件]  […]
autoreconf命令 – 更新已经生成的配置文件--->使用autoreconf命令可以重复编译指定目录下的系统文件或configure-ac指定的目录树。默认情况下 […]
zgrep命令 – 检索压缩包内文件的内容--->zgrep命令来自英文词组“gzipped grep”命令的缩写，其功能是用于检索压缩包内文件的内容 […]
rev命令 – 颠倒过来显示文件内容--->使用rev命令可以把每一行字符的顺序颠倒过来显示文件内容 语法格式： rev [文件] 参考实例 把每一行字符 […]
zdump命令 – 时区输出器--->使用zdump命令可以在命令行上显示指定的每个区域名称的当前时间 语法格式： zdump [参数] [区域名] […]
mke2fs命令 -创建文件系统--->mke2fs命令被用于创建磁盘分区上的“etc2/etc3”文件系统。 语法格式： mke2fs [参数] 常 […]
dumpe2fs命令 – 打印快组信息--->dumpe2fs命令用于打印“ext2/ext3”文件系统的超级块和快组信息。 语法格式： dumpe2fs  […]
xclip命令 – 跨窗口复制文字--->使用fsview命令方便的管理 X selections 里面内容的工具 。 语法格式：xclip [参数]  […]
xzcat命令 – 查看xz压缩文件的内容--->xzcat命令可以查看xz压缩文件的内容。 语法格式：xzcat [参数] [文件] 常用参数： -z 强制压 […]
htdigest命令 – 管理用户摘要认证文件--->htdigest命令是Apache的Web服务器内置工具，用于创建和更新存储用户名、域和用于摘要认证的密码文件 […]
dnsdomainname命令 – 打印DNS的域名--->dnsdomainname命令用于定义DNS系统中FQDN名称中的域名。 dnsdomainname命令仅打印 […]
readlink命令 – 找出符号链接所指向的位置--->readlink命令来自英文词组“read link”的拼写，中文译为“读取链接”，其功能是用于找出符号链接所 […]
fsview命令 – 文件系统浏览器--->使用fsview命令可以进行文件系统浏览。 语法格式：fsview [参数] [目录] 常用参数： –dis […]
mkfifo命令 – 创建FIFO文件--->使用mkfifo命令可以使用指定的名称创建先进先出文件（FIFO） 语法格式：mkfifo [参数] [名称] […]
install命令 – 复制文件和设置权限属性--->install命令来自英文单词“安装”，但单词含义与功能无任何关联，其功能是用于复制文件和设置权限属性。使用i […]
pinfo命令 – 基于lynx类型info浏览--->使用pinfo命令可以查看info文件，pinfo命令将搜索当前目录以及例如：/usr/share/info  […]
info命令 – 阅读info格式的文件--->info命令可以阅读info格式的文件，用来查看帮助信息。info文档可以支持链接跳转功能。info文档都存放 […]
manpath命令 – 查看man手册页的查询路径--->使用manpath命令可以查看和设置man手册页的查询路径。 语法格式：manpath [参数] [名称] 常 […]
nologin命令 – 限制用户登录--->使用nologin命令可以限制某些用户通过Shell登录系统。如果/etc/nologin.txt存在，显示其 […]
sulogin命令 – 单用户登录--->使用sulogin命令可以进行单用户登录，在启动时Shell将不会读取/etc/profile或$HOME/. […]
telinit命令 – 更改系统的运行级别--->使用telinit命令可以更改Linux系统的运行级别。运行级别可以是0~6之间的一个数字，其中0是关闭系统， […]
indent命令 – 调整代码文件格式--->indent命令用于调整C原始代码文件的格式。indent可辨识C的原始代码文件，并加以格式化，以方便程序设计 […]
joe命令 – 纯文本编辑器--->joe命令用于编辑文本文件。joe是一个功能强大的全屏幕文本编辑程序。操作的复杂度要比Pico高一点，但是功能 […]
dris命令 – 显示和清空目录堆栈中的内容--->dris命令用于显示和清空目录堆栈中的内容。 语法格式：dris [参数] 常用参数： +n 显示从左边算起第 […]
bzmore命令 – 查看bzip2压缩过的文本文件的内容--->bzmore命令用于查看bzip2压缩过的文本文件的内容，当下一屏显示不下时可以实现分屏显示。 语法格式：bz […]
bzless命令 – 查看bzip2压缩过的文本文件的内容--->bzless命令是增强 .bz2 压缩包查看器，bzless比bzmore命令功能更加强大。 语法格式：bzl […]
mread命令 – mtools工具--->mread命令用于将MS-DOS文件复制到Linux/Unix的目录中。 mread为mtools工具命令，可 […]
mshowfat 命令 – 显示在FAT中的记录--->mshowfat命令用于显示MS-DOS文件在FAT中的记录。 mshowfat为mtools工具指令，可显示 […]
mren命令 – 更改文件或目录--->mren命令用于更改MS-DOS文件或目录的名称，或是移动文件或目录。 mren为MS-DOS工具指令，与DO […]
lftpget命令 – 下载指定的文件--->lftp是linux中一款ftp服务器，相比windows中的ftp显得要复杂不少了，下面我来总结一下lftp […]
apk命令 – 下载包管理工具--->Android应用程序包（APK）是android操作系统使用的应用程序包文件格式，用于分发和安装移动应用及中 […]
apropos命令 – 在whatis数据库中查找字符串--->apropos命令在一些特定的包含系统命令的简短描述的数据库文件里查找关键字，然后把结果送到标准输出。 如果你 […]
uucico命令 – 文件传输服务程序--->uucico命令是UUCP文件传输服务程序。uucico是用来处理uucp或uux送到队列的文件传输工具。uu […]
semanage命令 – 查询与修改安全上下文--->semanage命令来自英文词组“SELinux manage”的缩写，其功能是用于查询与修改安全上下文。se […]
rpmverify命令 – 验证已安装的RPM软件包的正确性--->rpmverify命令用来验证已安装的rpm软件包的正确性。 语法格式： rpmverify [参数] 常用参 […]
e2image命令 – 保存ext2/ext3文件元数据--->e2image命令可以将处于危险状态的“ext2”或者“ext3”文件系统保存到文件中。生成的文件可以被dum […]
get_module命令 – 获取模块信息--->get_module命令用于获取Linux内核模块的详细信息。 使用get_module命令获取模块详细信息时 […]
xlsfonts命令 – 显示X服务器字体列表--->xlsfonts命令显示当前X服务器使用的字体列表，也能使用范本样式仅列出的符合条件的字体。 运行xlsfon […]
getopt命令 – 解析命令行选项--->getopt命令用于解析命令行选项，检测给定的选项是否合法。在此命令中，选项部分主要用于影响getopt命令解 […]
basename命令 显示文件路径名的基本文件名--->basename命令主要用于显示文件路径名剔除目录部分后的显示文件名。如何指定了后缀参数suffix，同时也删 […]
dpkg-split命令 – 分割软件包--->dpkg-split命令用来将Debian linux中的大软件包分割成小软件包，它还能够将已分割的文件进行合 […]
dpkg-statoverride命令 – 改写所有权和模式--->dpkg-statoverride命令是Debian linux下改写软件包状态的实用工具，dpkg-stat […]
dpkg-trigger命令 – 软件包触发器--->dpkg-trigger命令是Debian linux下的软件包触发器。 dpkg-trigger命令只能应用 […]
dpkg-reconfigure命令 – 重新配置已安装的软件包--->dpkg-reconfigure命令是Debian linux中重新配置已经安装过的软件包，可以将一个或者多个 […]
dpkg-query命令 – 在dpkg数据库中查询软件包--->dpkg-query命令是Debian linux中软件包的查询工具，它从dpkg软件包数据库中查询并显示软件 […]
dpkg-preconfigure命令 – 软件包安装之前询问问题--->dpkg-preconfigure命令用于在Debian linux中软件包安装之前询问问题。如果软件包不需要 […]
dpkg-divert命令 – 将文件安装到转移目录--->dpkg-divert命令是用于将引起冲突的文件安装到转移目录而非默认目录。 语法格式: dpkg-diver […]
dpkg-deb命令 – deb软件包管理器--->dpkg-deb命令来自英文词组“Debian package”的缩写，其功能是用于管理deb软件包。dpkg […]
apt-key命令 – 管理APT软件包密钥信息--->apt-key命令来自英文词组“APT-key”的拼写，其功能是用于管理APT软件包密钥信息。APT的全称为A […]
apt-sortpkgs命令 – 排序软件包索引文件--->apt-sortpkgs命令是Debian linux下对软件包索引文件进行排序的简单工具。 该命令会获取索引 […]
mc命令 – 菜单式文件管理程序--->mc命令用于提供一个菜单式的文件管理程序，执行mc之后，将会看到菜单式的文件管理程序，共分成４个部分。 语法格 […]
dirname命令 – 去除文件名中的非目录部分--->dirname命令去除文件名中的非目录部分，仅显示与目录有关的内容。dirname命令读取指定路径名保留最后一 […]
unrar命令 – 解压提取RAR压缩文件--->unrar命令来自英文词组“unzip rar”的缩写，其功能是用于解压提取RAR压缩文件。轻松解压来自于Wi […]
e2label命令 – 设置文件系统的卷标--->e2label命令用来设置第二扩展文件系统的卷标。 语法格式：e2label [参数] 常用参数： 文件系统  […]
strings命令 – 在对象文件或二进制文件中查找可打印的字符串--->strings命令在对象文件或二进制文件中查找可打印的字符串。字符串是4个或更多可打印字符的任意序列，以换行符 […]
source命令 – 从指定文件中读取和执行命令--->source命令的功能是用于从指定文件中读取和执行命令，通常用于被修改过的文件，使之新参数能够立即生效，而不必 […]
gdb命令 – GUN程序调试器--->gdb命令来自英文词组“GNU Debugger”的缩写，其功能是用于GNU程序调试。gdb命令是类UNIX系 […]
gcc命令 – C/C++语言编译器--->gcc命令来自英文词组“GNU Compiler Collection”的缩写，其功能是用于C/C++语言编译 […]
as命令 – 汇编语言编译器--->as命令的功能是用于汇编语言编译器，属于二进制工具集GNU Binutils的一员，也是GNU开放源代码项目推 […]
mysqladmin命令 – MySQL服务器客户端管理工具--->mysqladmin命令是MySQL服务器管理任务的客户端工具，它可以检查MySQL服务器的配置和当前工作状态 […]
gcov命令 – 测试代码覆盖率--->gcov命令是一款测试程序的代码覆盖率的工具。 gcov可以统计每一行代码的执行频率，实际上哪些代码确实被执行 […]
ldd命令 – 打印程序依赖的共享库--->ldd命令用于打印程序或者库文件所依赖的共享库列表。 语法格式: ldd [参数] [文件] 常用参数： -v […]
ld命令 – GUN连接器--->ld命令是GNU的连接器，将目标文件连接为可执行程序。 很少单独使用ld命令对目标进行连接操作，通常都是使用g […]
mysql命令 – MySQL服务器的客户端工具--->mysql命令的功能是用于MySQL服务器的客户端工具，它工作在Shell命令行终端中，完成对远程MySQL数 […]
mysqlimport命令 – MySQL服务器数据导入--->mysqlimport命令为MySQL数据库服务器提供了一种命令行方式导入数据工具，它从特定格式的文本文件中读 […]
unprotoize命令 – 删除函数原型--->unprotoize命令属于gcc套件，用于删除C语言源代码文件中的函数原型。 语法格式：unprotoize […]
unlink命令 – 删除文件--->unlink命令来自英文单词，中文译为“取消链接”，其功能是用于删除文件。unlink命令通过系统中的unli […]
tailf命令 – 跟踪输出文件的新内容--->tailf命令来自英文词组“tail file”的缩写，其功能是用于跟踪输出文件的新内容，无限相像于“tail […]
mysqldump命令 – MySQL数据库备份--->mysqldump命令是MySQL数据库中备份工具，用于将MySQL服务器中的数据库以标准的sql语言的方式导 […]
chown命令 – 改变文件或目录的用户和用户组--->chown命令来自英文词组“change owner”的缩写，其功能是用于改变文件或目录的用户和用户组信息。管 […]
newusers命令 – 批量创建或更新用户信息--->newusers命令来自英文词组“create new users”的拼写，中文译为“创建新用户们”，其功能是 […]
lynx命令 – 终端上的纯文本浏览器--->lynx命令是终端上的纯文本模式的网页浏览器，没有JS引擎，不支持CSS排版、图形、音视频等多媒体信息。只能作 […]
stat命令 – 显示文件的状态信息--->stat命令来自英文单词status的缩写，其功能是用于显示文件的状态信息。Linux系统中每个文件都有三个“ […]
batch命令 – 指定时间执行任务--->batch命令用于在指定时间，当系统不繁忙时执行任务，用法与at相似。 batch命令是在当系统负载水平允许时 […]
diff3命令 – 比较3个文件的不同之处--->diff3命令用于比较3个文件，将3个文件的不同的地方显示到标准输出。 语法格式：diff3 [参数] 常用参 […]
uuname命令 – 显示全部的UUCP远端主机--->uuname命令用于显示全部的UUCP远端主机。 语法格式：uuname [参数] 常用参数： -a 显示别名 […]
statserial命令 – 显示串口状态--->statserial(status ofserial port)可显示各个接脚的状态，常用来判断串口是否正常。 […]
smbd命令 – Samba服务器程序--->smbd为Samba服务器程序，可分享文件与打印机等网络资源供Windows相关的用户端程序存取。 语法格式： […]
ytalk命令 – 与其他用户交谈--->通过ytalk指令，你可以和其他用户线上交谈，如果想和其他主机的用户交谈，在用户名称后加上其主机名称或IP地址 […]
uucp命令 – unix系统之间传输文件--->UUCP为Unix系统之间，通过序列线来连线的协议。uucp使用UUCP协议，主要的功能为传送文件。 语法格式 […]
vimdiff命令 – 同时编辑多个文本文件--->vimdiff命令来自英文词组“Vim differences”的缩写，其功能是用于同时编辑多个文本文件。对纯 […]
bunzip2命令 – bz2文件的解压缩程序--->bunzip2可解压缩.bz2格式的压缩文件。bunzip2实际上是bzip2的符号连接，执行bunzip2与 […]
apmd命令 – 进阶电源管理服务程序--->apmd命令用于进阶电源管理服务程序。apmd负责BIOS进阶电源管理(APM)相关的记录，警告与管理工作。  […]
minfo命令 – 显示MS-DOS文件系统的各项参数--->minfo命令用于显示MS-DOS文件系统的各项参数。 minfo为mtools工具指令，可显示MS-DOS系 […]
kbdconfig命令 – 设置键盘类型--->kbdconfig(Red Hat Linux才有的指令)是一个用来设置键盘的程序，提供图形化的操作界面。kb […]
chroot命令 – 切换根目录--->chroot命令来自英文词组“change root directory”的缩写，其功能是用于切换根目录。ch […]
rlogin命令 – 远端登入--->rlogin命令用于远端登入。执行rlogin指令开启终端机阶段操作，并登入远端主机。 语法格式：rlogin […]
gitps命令 – 报告程序状况--->gitps(gnu interactive tools process status)是用来报告并管理程序执行 […]
rename命令 – 批量修改文件名称--->rename命令的功能是用于批量修改文件名称。与mv命令一次只能修改一个文件名不同，rename命令能够基于正 […]
pr命令 – 将文本文件转换成适合打印的格式--->pr命令用来将文本文件转换成适合打印的格式，它可以把较大的文件分割成多个页面进行打印，并为每个页面添加标题。  […]
mmove命令 – 移动文件或目录--->Linux mmove命令用于在MS-DOS文件系统中，移动文件或目录，或更改名称。 mmove为mtools […]
smbclient命令 – 存取SMB/CIFS服务器的用户端程序--->SMB与CIFS为服务器通信协议，常用于Windows95/98/NT等系统。smbclient(samba  […]
su命令 – 切换用户身份--->su命令来自英文单词“switch user”的缩写，其功能是用于切换用户身份。管理员切换至任意用户身份而无须 […]
ipcs命令 – 多进程间通信常用的工具--->ipcs命令是用于报告Linux中进程间通信设施的状态，显示的信息包括消息列表、共享内存和信号量的信息 。 语 […]
cpio命令 – 复制文件到归档包--->cpio命令主要是用来建立或者还原备份档的工具程序，cpio命令可以复制文件到归档包中，或者从归档包中复制文件 […]
systool命令 – 显示系统中设备的信息--->systool命令指令显示基于总线、类和拓扑显示系统中设备的信息。 语法格式：systool [参数] 常用参 […]
objdump命令 – 显示目标文件附加信息--->objdump命令来自于英文词组“object files dump”的缩写，其功能是用于显示目标文件附加信息 […]
expand命令 – 转换为空白字符--->expand命令用于将文件的制表符（TAB）转换为空白字符（space），将结果显示到标准输出设备。 语法格式 […]
nl命令-显示文件内容及行号--->nl命令来自英文词组“Number of lines”的缩写，其功能是用于显示文件内容及行号，使用nl命令会有 […]
iperf命令 – 网络性能测试--->iperf是一款进行网络性能测试的命令工具，由美国伊利诺伊大学研发和维护。可以用来测试一些网络设备如路由器，防 […]
dd命令 – 拷贝及转换文件--->dd命令来自英文词组“disk dump”的缩写，其功能是用于拷贝及转换文件。使用dd命令可以按照指定大小的数 […]
blkid命令 – 显示块设备信息--->blkid命令来自英文词组“block ID”的缩写，其功能是用于显示块设备信息。blkid命令能够查看Lin […]
docker命令 – 管理应用容器引擎--->docker命令的功能是用于管理应用容器引擎，可以让开发者们打包他们的应用以及依赖包到一个可移植的容器中，然后 […]
nmcli命令 – 基于命令行配置网卡参数--->nmcli命令来自英文词组“NetworkManager command-line”的缩写，其功能是用于基于命 […]
ethtool命令 – 查询与设置网卡参数--->ethtool命令来自英文词组“ethernet tool”的缩写，其功能是用于查询与设置网卡参数。使用eth […]
restore命令 – 还原备份--->restore命令用来还原由dump操作所备份下来的文件或整个文件系统(一个分区)。 语法格式：restore […]
gzexe命令 – 压缩执行文件--->gzexe命令用来压缩可执行文件，压缩后的文件仍然为可执行文件，在执行时进行自动解压缩。当您去执行被压缩过的执 […]
hping3命令 – 测试网络及主机的安全--->hping3命令是用于生成和解析TCPIP协议数据包的开源工具，也是安全审计、防火墙测试等工作的标配工具 。  […]
dos2unix命令 – 将DOS格式的文本文件转换成UNIX格式--->dos2unix命令用来将DOS格式的文本文件转换成UNIX格式的（DOS/MAC to UNIX text  […]
awk命令 – 文本和数据进行处理的编程语言--->awk命令来自三位创始人“Alfred Aho，Peter Weinberger, Brian Kernigh […]
mdel命令 – 删除 MSDOS 格式的档案--->mdel为mtools工具命令，模拟MS-DOS的deltree命令，可删除MS-D0S文件系统中的目录及目录 […]
mdir命令 – 显示MS-DOS目录--->mdir为mtools工具指令，模拟MS-DOS的dir指令，可显示MS-DOS文件系统中的目录内容。 语法格 […]
patch命令 – 给文件打补丁--->patch命令来自于英文单词“修补”，其功能是用于给文件打补丁。倘若一次仅修改一个文件，可直接在指令列中下达指 […]
split命令 – 分割文件内容--->split命令来自英文单词“分裂”，其功能是用于分割文件内容。Linux系统运维人员可以使用split命令对指 […]
mcopy命令 – 复制 MSDOS 格式文件到Linux中--->mcopy命令用来复制 MSDOS 格式文件到 Linux 中，或是由 Linux 中复制 MSDOS 文件到 […]
setenv命令 – 设置与显示系统环境变量信息--->setenv命令来自英文词组“set environment variable”的缩写，其功能是用于设置与显示 […]
diff命令 – 比较文件内容差异--->diff命令来自英文单词“different”的缩写，其功能是用于比较文件内容差异。如果有多个内容相近的文件， […]
diffstat命令 – 显示统计数字--->diffstat命令用于读取diff的输出结果，然后统计各文件的插入，删除，修改等差异计量 。 语法格式：di […]
umask命令 – 管理权限掩码--->umask命令来自英文词组“user file-creation mode mask”的缩写，其功能是用于管理 […]
mtoolstest命令 – 测试并显示mtools的相关设置--->mtoolstest为mtools工具指令，可读取与分析mtools的配置文件，并在屏幕上显示结果 。 语法格 […]
od命令 – 输出文件内容--->od命令会读取所给予的文件的内容，并将其内容以八进制字码呈现出来。 语法格式：od [参数] 常用参数： -a […]
insmod命令 – 载入模块--->insmod命令用于将给定的模块加载到内核中。 Linux有许多功能是通过模块的方式，在需要时才载入kerne […]
zcat命令 – 查看压缩文件的内容--->zcat命令来自英文词组“zip cat”的缩写，其功能是用于查看压缩文件的内容。zcat命令可以在不真正解压 […]
setconsole命令 – 设置系统终端--->setconsole命令用于设置系统终端，可用来指定系统终端。 语法格式：setconsole [参数] 常用 […]
swapoff命令 – 关闭SWAP交换分区--->swapoff命令来自英文词组“SWAP off”的缩写，其功能是用于关闭SWAP交换分区。SWAP交换分区是 […]
stty命令 – 修改终端命令行的相关设置--->stty命令用于检查和修改当前注册的终端的通信参数。UNIX系统为键盘的输入和终端的输出提供了重要的控制手段， […]
resize命令 – 设置终端机视窗的大小--->resize命令设置终端机视窗的大小。执行resize指令可设置虚拟终端机的视窗大小。 语法格式：resize […]
export命令 – 将变量提升成环境变量--->export命令的功能是用于将变量提升成环境变量，亦可将Shell函数输出为环境变量。通常个人创建出的变量仅能 […]
renice命令 – 系统管理--->renice命令可以修改正在运行的进程的调度优先级。 该命令预设是以程序识别码指定程序调整其优先权，您亦可以指 […]
slocate命令 – 查找文件或目录--->slocate本身具有一个数据库，里面存放了系统中文件与目录的相关信息 。 语法格式：slocate [参数] […]
tee命令 – 读取标准输入的数据--->tee命令的功能是用于读取标准输入的数据，将其内容转交到标准输出设备中，同时保存成文件。 语法格式：tee [ […]
mtools命令 – 显示mtools支持的指令--->mtools为MS-DOS文件系统的工具程序，可模拟许多MS-DOS的指令。这些指令都是mtools的符号连接 […]
tmpwatch命令 – 删除暂存文件--->执行tmpwatch指令可删除不必要的暂存文件，您可以设置文件超期时间，单位以小时计算 。 语法格式：tmpw […]
sum命令 – 计算文件的校验码和显示块数--->sum命令用于计算并显示指定文件的校验和与文件所占用的磁盘块数 语法格式：sum[参数] 常用参数： -r 使 […]
unset命令 – 删除指定的shell变量或函数--->unset命令用于删除已定义的shell变量（包括环境变量）和shell函数。unset命令不能够删除具有只读 […]
rhmask命令 – 加密和解密文件--->Linux rhmask命令用于对文件进行加密和解密操作。执行rhmask指令可制作加密过的文件，方便用户在公 […]
read – 读取单行数据内容--->read命令的功能是用于读取单行数据内容，一般是从标准输入中读取数值，用于给变量赋值。 语法格式：read [ […]
updatedb命令 – 创建或更新数据库文件--->updatedb命令用来创建或更新 slocate/locate 命令所必需的数据库文件。 updatedb命 […]
gitview命令 – 查看文件内容--->gitview的命令全称为“gnu interactie tools viewer”。该命令用于查看文件内容。 […]
tree命令 – 以树状图形式列出目录内容--->tree命令的功能是用于以树状图形式列出目录内容，帮助运维人员快速了解到目录的层级关系。 语法格式：tree  […]
umount命令 – 卸载文件系统--->umount命令来自英文单词“unmount”的缩写，其功能是用于卸载文件系统。与mount挂载命令需要同时提 […]
setfacl命令 – 设置文件ACL策略规则--->setfacl命令来自英文词组“Set file access control list”的缩写，其功能是用于 […]
last命令 – 显示用户历史登录情况--->last命令的功能是用于显示用户历史登录情况，通过查看系统记录的日志文件内容，进而使管理员可以获知谁曾经或者试 […]
chmod命令 – 改变文件或目录权限--->chmod命令来自英文词组“change mode”的缩写，其功能是用于改变文件或目录权限的命令。默认只有文件 […]
scp命令 – 基于SSH协议远程复制文件--->scp命令来自英文词组“secure copy”的缩写，其功能是用于基于SSH协议远程拷贝文件。scp命令可以 […]
md5sum命令 – 计算文件内容的md5值--->md5sum命令来自英文词组“md5 summation”的缩写，其功能是用于计算文件内容的md5值，进而比较 […]
more命令 – 分页显示文本文件内容--->more命令的功能是用于分页显示文本文件内容。如果文本文件中的内容较多较长，使用cat命令读取后则很难看清，这 […]
rcp命令 – 远程文件复制--->rcp命令的英文是“remote file copy”，即远程文件复制，可以使在两台Linux主机之间的文件复 […]
chfn命令 – 系统管理--->chfn命令的英文全称是“change finger”，即用来改变finger命令显示的信息。这些信息都存放在 […]
hwclock命令 – 显示与设置系统硬件时钟--->hwclock命令来自英文词组“hardware clock”的缩写，其功能是用于显示与设置系统硬件时钟。hw […]
alias命令 – 设置命令别名--->alias命令来自英文单词“alias”，中文译为“别名”，其功能是用于设置命令别名信息。我们可以使用alia […]
which命令 – 查找命令文件--->which命令的功能是用于查找命令文件，能够快速搜索二进制程序所对应的位置。如果我们既不关心同名文件（find […]
cmp命令 – 比较两个文件是否有差异--->cmp命令有用于比较两个任意类型的文件，若两个文件相同则默认不输出任何信息，若两个文件不同，则会输出第一个不同 […]
cut命令 – 按列提取文件内容--->cut命令的功能是用于按列提取文件内容。常用的grep命令仅能对关键词进行按行提取过滤，而cut命令则是可以根 […]
mktemp命令 – 建立暂存文件--->mktemp用来建立暂存文件，其创建的临时文件是唯一的 ，供shell 使用 。 默认情况下，mktemp会在 […]
mattrib命令 – 更改或显示MS-DOS文件的属性--->mattrib命令用于变更或显示MS-DOS文件的属性，MS-DOS文件是指记录在存储介质（如磁盘、光盘）上的 […]
file命令 – 识别文件类型--->file命令的功能是用于识别文件类型，也可以用来辨别一些内容的编码格式。由于Linux系统并不是像Window […]
less命令 – 分页显示文件内容--->less命令的功能是用于分页显示文件内容。分页显示的功能与more命令很相像，但more命令只能从前向后浏览文 […]
sort命令 – 对文件内容进行排序--->sort命令的功能是对文件内容进行排序。有时文本中的内容顺序不正确，一行行的手动修改实在太麻烦了。此时使用so […]
whereis命令 – 显示命令及相关文件的路径位置--->whereis命令来自英文词组“Where is”的拼写，其功能是用于显示命令及相关文件的路径位置信息，能够找 […]
lsattr命令 – 显示文件的隐藏属性--->lsattr命令来自英文词组“list attribute”的缩写，其功能是用于显示文件的隐藏属性。隐藏属性也 […]
wc命令 – 统计文件的字节数、单词数、行数--->wc命令来自英文词组“Word count”的缩写，其功能是用于统计文件的字节数、单词数、行数等信息，并将统计 […]
locate命令 – 快速查找文件或目录--->locate命令的功能是用于快速查找文件或目录。与find命令进行全局搜索不同，locate命令是基于了数据文 […]
cksum命令 – 校验文件--->cksum命令用于检查文件的CRC是否正确， 确保文件从一个系统传输到另一个系统的过程中的正确性 。循环冗余校 […]
traceroute命令 –  追踪网络数据包传输路径--->traceroute命令来自英文词组“Trace router”的拼写，其功能是用于追踪网络数据包传输路径。执 […]
cd命令 – 切换目录--->cd命令来自英文词组“change directory”的缩写，其功能是用于更改当前所处的工作目录，路径可以是 […]
chattr命令 – 更改文件隐藏属性--->chattr命令来自英文词组“change attribute”的缩写，其功能是用于更改文件隐藏属性。常用的l […]
ln命令 – 为文件创建快捷方式--->ln命令来自英文单词“link”的缩写，中文译为“链接”，其功能是用于为某个文件在另外一个位置建立同步的链接。 […]
userdel命令 – 删除用户账户--->userdel命令来自英文词组“user delete”的缩写，其功能是删除用户账户。Linux系统中一切都是 […]
touch命令 – 创建空文件与修改时间戳--->touch命令的功能是用于创建空文件与修改时间戳。如果文件不存在，则会创建出一个空内容的文本文件；如果文件已经 […]
mv命令 – 移动或改名文件--->mv命令来自英文单词”move“的缩写，中文译为”移动“，其功能与英文含义相同，能够用于对文件进行剪切和重命名 […]
pwd命令 – 显示当前工作目录的路径--->pwd命令来自英文词组“print working directory”的缩写，其功能是用于显示当前工作目录的 […]
cp命令 – 复制文件或目录--->cp命令来自英文单词“copy”的缩写，中文译为“复制”，其功能是用于复制文件或目录。cp命令能够将一个或多个 […]
mkdir命令 – 创建目录文件--->mkdir命令来自英文词组”make directories“的缩写，其功能是用来创建目录文件。使用方法简单， […]
ls命令 – 显示目录中文件及其属性信息--->ls命令来自英文单词”list“的缩写，中文译为“列出”，其功能是用于显示目录中文件及其属性信息，是最常被使用 […]