arpaname命令 – IP地址转换为对应的ARPA名称--->arpaname命令的作用是可以转换IP地址（IPv4和IPv6）到相应的IN-ADDR.ARPA或IP6.A […]
ntptrace命令 – 追踪NTP服务器链--->ntptrace是一个 perl 脚本，它使用 ntpq 实用程序来跟踪从给定主机到主要时间源的 NTP 服务 […]
ntpdc命令 – 查询NTP守护进程--->ntpdc是一个实用程序，用于查询 ntpd(8) 的当前状态，并请求改变其状态。 它使用源代码中描述的 NT […]
ntpd命令 – 网络时间协议(NTP)的守护进程--->ntpd命令来自英文词组“network time protocol daemon”的缩写，其功能是用于网络时 […]
open命令 – 启用虚拟终端--->open命令的作用是可以启用虚拟终端，然后执行指定的命令。 虚拟终端类似于你目前使用的终端。它们用于执行命令和 […]
nmblookup命令 – 通过TCP/IP客户端来查找NetBIOS名称--->使用nmblookup命令可以通过TCP/IP客户端来查找NetBIOS名称。比方说可以查看windows主机 […]
gluster命令 – Gluster控制台管理工具--->gluster是一个免费的开源软件可扩展网络文件系统，Gluster Console Manager是一个用于 […]
xrdp命令 – RDP连接Linux远程桌面--->xrdp是一个远程桌面协议(RDP)服务器，与Windows NT/2000/2003服务器不同的是，xrdp […]
netconf命令 – 设置网络功能参数--->netconf命令来自英文词组“network configure”的缩写，其功能是用于设置网络功能参数。ne […]
mutt命令 – E-mail管理程序--->mutt是一个文字模式的邮件管理程序，提供了全屏幕的操作界面。 它是一款基于文字界面的邮件客户端，非常小巧，但 […]
ctlinnd命令 – 设置INN新闻组服务器--->通过ctlinnd指令，可以对新闻组服务器这项常驻服务下达控制命令，直接设置相关数值。 语法格式：ctlinn […]
vmkping – 网络故障排除命令--->Vmkping是VMware的Ping命令的特定版本。它使用的IP VMkernel去Ping另一个ESX主机 […]
pine命令 – 收发电子邮件，浏览新闻组--->pine是个以显示导向为住的邮件处理程序，包括一般电子邮件和新闻组的文章。pine也支持MIME格式，可让用户 […]
nntpget命令 – 下载新闻组文章--->执行nntpget命令将从指定的新闻组服务器下载文章。nntpget命令会从标准输入设备读取信息识别码，而下载 […]
sftp-server命令 – SFTP协议服务端程序--->sftp-server命令来自英文词组“SFTP server”的拼写，其功能是用于SFTP协议服务端程序。S […]
ppp-off命令 – 关闭ppp连线--->ppp-off命令是Slackware发行版内附的程序，让用户切断PPP的网络连线。 语法格式：ppp-off […]
iptables命令 – 防火墙策略管理工具--->iptables是一个防火墙策略管理工具的命令，同时也是一个基于内核级别的防火墙服务，用户可以基于它来对数据包 […]
jwhois命令 – whois 客户端服务--->jwhois命令是在Whois服务器上搜索命令行上要查询的域名主机。从Whois服务器的全局的配置文件具有一定 […]
links命令 – 命令行web浏览器--->links是一个文本模式的WWW浏览器，带有ncurses界面，支持颜色、正确的表格渲染、后台下载、菜单驱动的 […]
dhcpd命令 – 管理DHCP服务程序--->dhcpd命令来自英文词组“DHCP daemon”的缩写，其功能是用于管理DHCP服务程序。执行dhcpd命 […]
dhcrelay命令 – 提供中继DHCP和BOOTP请求--->dhcrelay命令可以提供中继DHCP和BOOTP请求，从一个没有DHCP服务器的子网直接连接到其它子网内的 […]
iftop命令 – 套接字及进程的网络利用率--->iftop是一款实时流量监控工具,监控TCP/IP连接等,缺点就是无报表功能。必须以root身份才能运行。 语 […]
pppsetup命令 – 设置PPP连线--->pppsetup命令用于设置PPP连线，这是Slackware发行版内附程序，它具有互动式的问答界面，让用户轻 […]
fping命令 – 检测主机是否存在--->fping类似于ping（ping是通过ICMP（网络控制信息协议InternetControl Messag […]
elm命令 – 纯文本邮件客户端程序--->elm命令是ELectronic Mail单词的缩写，是一个E-mail客户端管理程序，它提供了纯文本交互式全 […]
arptables命令 – ARP包过滤管理工具--->arptables命令用来设置、维护和检查Linux内核中的arp包过滤规则表。使用arptables命令可以 […]
nisdomainname命令 – 显示主机NIS的域名--->nisdomainname命令用于显示主机NIS的域名。 注意区分DNS域名和NIS域名，前者为因特网的标准域 […]
tcpdump命令 – 监听网络流量--->tcpdump命令的功能是用于监听网络流量，是一款数据嗅探工具，Linux系统中常用的数据抓包软件，能够记录所 […]
ypdomainname命令 – 显示主机的NIS的域名--->ypdomainname命令的作用是显示由函数“getdomainname”返回的主机域名，使用这个命令也可以 […]
mailstat命令 – 显示到达的邮件状态--->mailstat命令用来显示到达的邮件状态。它显示的邮件状态是基于邮件的日志文件。 mailstat命令需要读 […]
rexec命令 – 远程执行指令客户端--->rexec命令是远程执行命令服务器的客户端工具，向远程rexec服务器发出执行命令的请求。 rexec命令以客 […]
mingetty命令 – 登入程序--->mingetty命令是精简版的getty。 mingetty适用于本机上的登入程序。 语法格式：mingett […]
newaliases命令 – 文字模式转换--->Linux newaliases命令会使用一个在 /etc/aliases 中的档案做使用者名称转换的动作。当 […]
minicom命令 – 通信程序--->Linux minicom命令用于调制解调器通信程序。 minicom是一个相当受欢迎的PPP拨号连线程序。  […]
efax命令 – 收发传真--->efax命令用于收发传真；支持Class 1与Class 2的调制解调器来收发传真。 语法格式：efax [参 […]
rpcinfo命令 – 查询RPC服务信息--->rpcinfo命令来自英文词组“RPC information”的缩写，其功能是用于查询RPC服务信息。rpc […]
ipvsadm命令 – 管理Linux虚拟服务器--->ipvsadm命令来自英文词组“IPVS administration”的缩写，其功能是用于管理Linux虚拟 […]
cu命令 – 连接另一个系统主机--->cu命令可连接另一台主机，并采用类似拨号终端机的接口工作，也可执行简易的文件传输作业。 语法格式：cu [参数 […]
nethogs命令 – 实时统计网络带宽使用率工具--->nethogs是一个小型的net top工具，不像大多数工具那样拖慢每个协议或者是每个子网的速度而是按照进程进 […]
setserial命令 – 设置或显示串口的相关信息--->setserial命令可以用来设置串口或显示目前串口的状态信息。 语法格式：setserial [参数] [设 […]
dnsconf命令 – 设置DNS服务器组态--->dnsconf命令实际上为linuxconf的符号连接，提供图形的操作方式，供管理员管理DNS服务器。 语法格 […]
iptraf-ng命令 – 交互式彩色IP LAN监视器--->iptraf-ng命令是一个基于ncurses的IP LAN监视器，可生成各种网络统计信息，包括TCP信息，U […]
speedtest-cli命令 – 测试服务器外网速度--->speedtest-cli 是一个使用python编写的命令行脚本，通过调用speedtest.ne […]
squidclient命令 – squid客户端管理工具--->squidclient命令使用squid服务的客户端管理工具，它可以查看squid服务的详细运行信息和管理sq […]
smbpasswd命令 – 修改用户的SMB密码--->smbpasswd命令来自英文词组“samba password”的缩写，其功能是用于修改用户的SMB密码。s […]
showmount命令 – 显示NFS服务器的共享信息--->showmount命令来自英文词组“show mounted disk”的缩写，其功能是用于显示NFS服务器的 […]
sendmail命令 – 电子邮件传送代理--->sendmail命令是一款著名的电子邮件传送代理程序，也就是平常所说的电子邮件服务器，它基于标准的简单邮件传送 […]
mysqlshow命令 – 显示数据库、数据表和列信息--->mysqlshow命令用于显示MySQL服务器中的数据库、表和列信息。 语法格式: mysqlshow [参数 […]
squid命令 – 代理服务器守护进程--->squid命令是使用最广泛的代理服务器软件，可以节省网络带宽，提高网站的访问速度，它对服务器硬件的内存要求比较 […]
iptstate命令 – 以top风格显示内核的iptables状态--->iptstate命令以top命令类似的风格实时显示Linux内核中iptables的工作状态。输出信息可以以任 […]
ssh-keyscan命令 – 收集主机的SSH公钥信息--->ssh-keyscan命令来自英文词组“SSH key scan”的拼写，其功能是用于收集主机的SSH公钥信息 […]
sshd命令 – openssh服务器守护进程--->sshd命令来自英文词组“SSH daemon”的缩写，其功能是用于openssh服务器守护进程。openss […]
ssh命令 – 安全的远程连接服务器--->ssh命令的功能是用于安全的远程连接服务器主机系统，作为openssh套件中的客户端连接工具，ssh命令可以让 […]
mii-tool命令 – 网络设备协商工具--->mii-tool命令是用于查看、管理介质的网络接口的状态，有时网卡需要配置协商方式，比如10/100/1000 […]
nc命令 – 连接与扫描指定端口--->nc命令来自英文词组“Net Cat”的缩写，其功能是用于扫描与连接指定端口。nc命令是一个功能丰富的网络实用 […]
shapecfg命令 – 管制网络设备的流量--->shapecfg命令用于管制网络设备的流量。自Linux-2.15开始,便支持流量管制的功能。 语法格式：sh […]
ifstat命令 – 统计网络信息--->ifstat命令就像iostat/vmstat描述其它的系统状况一样，是一个统计网络接口活动状态的工具。ifs […]
ip命令 – 显示与配置网卡参数--->ip命令的功能是用于显示与配置网卡参数。作为Linux系统下一款好用的网卡参数配置工具，ip命令除了常规操作外 […]
httpd命令 – Apache HTTP服务器程序--->httpd为Apache HTTP服务器程序。直接执行程序可启动服务器的服务。 语法格式：httpd [参数] […]
usernetctl命令 – 操作指定的网络接口--->usernetctl命令在用于被允许时操作指定的网络接口。在使用上和”ifup”、&# […]
rdate命令 – 显示其他主机的日期与时间--->执行rdate命令，向局域网或者网络上其他主机询问系统时间并打印显示出来。也可以将其他主机的时间同步为本机时间 […]
mail命令 – 发送和接收邮件--->mail命令的功能是用于发送和接收邮件，是Linux系统中重要的电子邮件管理工具，自RHEL / CentOS […]
domainname命令 – 显示和设置系统的NIS域名--->domainname命令作用是显示或设置当前网络信息服务（NIS）域的名称。如果不指定参数domainname […]
elinks命令 – 网络应用--->elinks命令能实现一个纯文本界面的WWW浏览器。 语法格式：elinks [参数] 常用参数： -anon […]
sftp命令 – 加密传输FTP文件--->sftp命令来自英文词组“secure file transfer protocol”的缩写，其功能是用于加密 […]
apachectl命令 – Apache服务器前端控制工具--->apachectl命令是Apache的Web服务器前端控制工具，用以启动、关闭和重新启动Web服务器进程。 语 […]
ifdown命令 – 禁用网络接口--->ifdown命令来自英文词组“interface down”的缩写，其功能是用于禁用网络接口。ifdown命令 […]
ifup命令 – 激活网络接口--->ifup命令来自英文词组“interface up”的缩写，其功能是用于激活网络接口。ifup命令会去读取Li […]
mailq命令 – 显示待发送的邮件队列--->mailq命令作用是显示用户待发送的邮件队列，显示的每一个条目包括邮件队列id、邮件大小、加入队列时间、邮件发 […]
ftptop命令 – 显示服务器的连接状态--->ftptop命令的作用是使用top命令的显示风格显示服务器的连接状态。 语法格式：ftptop [参数] 常用 […]
iptraf命令 – 实时监视网卡流量--->iptraf命令来自英文词组“IP traffic monitor”的缩写，其功能是用于实时监视网卡流量。使用 […]
htpasswd命令 – 管理用户基本认证文件--->htpasswd命令是Apache的Web服务器内置工具，用于创建和更新储存用户名、域和用户基本认证的密码文件 […]
talk命令 – 用于与其他使用者对谈--->talk命令允许同一主机或不同主机上的两个用户进行交互式对话。talk命令在每个用户的显示器上打开发送窗口和接 […]
samba命令 – 控制Samba服务器--->samba为script文件，可启动，停止Samba服务器或回报目前的状态。 Samba是一套使用SMB(Se […]
mesg命令 – 设置终端机的写入权限--->mesg命令用于设置当前终端的写入权限，即是否让其他用户向本终端发信息。将mesg设置y时，其他用户可利用wr […]
uulog命令 – 显示UUCP记录文件--->uulog 命令显示了日志文件的内容。该内容包含了 uucico 和  […]
telnet命令 – 控制远程设备--->telnet命令的功能是用于控制远程主机，作为常用的telnet协议的客户端工具，使用该命令后能够控制一切开启 […]
uux命令 – 在远端的UUCP主机上执行命令--->uux可以在远端的UUCP主机上执行指令或是执行本机上的命令，但在执行时会使用远端电脑的文件。 uux命令是一 […]
getty命令 – 用于设置终端机模式--->getty命令用于设置终端机模式，连线速率和管制线路。 getty命令是UNIX之类操作系统启动时所必须的3个 […]
dip命令 – 用于IP拨号连接--->dip命令是一种linux网络通讯命令，可以用于IP拨号连接。dip命令可以控制调制解调器，以拨号IP的方式建 […]
arpwatch命令 – 监听网络上ARP的记录--->arpwatch命令用于监听网络上ARP的记录。 ARP(Address Resolution Protoco […]
nmap命令 – 网络探测及端口扫描工具--->nmap命令来自英文词组“Network Mapper”的缩写，中文译为网络映射器，其功能是用于网络探测及端口 […]
pppstats命令 – 用于显示PPP连线状态--->pppstats命令用于显示PPP连线状态。 利用pppstats(point to point protoc […]
dhclient命令 – 动态获取或释放IP地址--->dhclient命令来自英文词组“DHCP client”的缩写，其功能是用于动态获取或释放IP地址。使用dh […]
lnstat命令 – 显示Linux系统的网路状态--->lnstat命令实际上是读取系统“/proc”中目录“/proc/net/stat”下面的文件，来显示当前主机 […]
ifcfg命令 – 配置网络接口--->ifcfg命令是一个Bash脚本程序，用来设置linux中的网络接口参数。 语法格式： ifcfg  […]
route命令 – 显示与设置路由信息--->route命令的功能是用于显示与设置路由信息，是Linux系统中常用的静态路由配置工具。要想让两台处在不同子网 […]
arping命令 – 发送ARP请求报文--->arping命令来自英文词组“ARP ping”的缩写，其功能是用于发送ARP请求报文，ARP全称为“Addr […]
host命令 – 解析域名结果--->host命令的功能是用于解析域名结果，是一个查找DNS解析结果的简单程序。将域名转换成IP地址形式，帮助运维人 […]
dig命令 – 查询域名DNS信息--->dig命令来自英文词组“domain information groper”的缩写，其功能是用于查询域名DNS […]
tracepath命令 – 追踪报文的路由信息--->tracepath命令来自英文词组“Trace Path”，其功能是用于追踪报文的路由信息。tracepath […]
nslookup命令 – 查询域名服务器信息--->nslookup命令来自英文词组“Nameserver lookup”的缩写，其功能是用于查询域名服务器信息。 […]
arp命令 – 管理系统arp缓存信息--->arp命令来自英文词组“Address Resolution Protocol”的缩写，其功能是用于管理系统a […]
ifconfig命令 – 显示或设置网络设备参数信息--->ifconfig命令来自英文词组“network interfaces configuring”的缩写，其功能 […]
netstat命令 – 显示网络状态--->netstat命令来自英文词组“network statistics”的缩写，其功能是用于显示各种网络相关信息 […]
ss命令 – 显示活动套接字信息--->ss命令来自英文词组“Socket Statistics”的缩写，其功能是用于显示活动套接字信息。如果您之前使 […]
ipcalc命令 – 简单的IP地址计算器--->ipcale命令来自英文词组“IP Calculate”的缩写，其功能是用于简单的IP地址计算任务。比起Lin […]
ping命令 – 测试主机间网络连通性--->ping命令的功能是用于测试主机间网络连通性，发送出基于ICMP传输协议的数据包，要求对方主机予以回复，若对方 […]