pwdhash命令 – 密码哈希生成器--->pwdhash命令的作用是可以在LDIF密码字段中生产可以使用的密码哈希值。 哈希值是一段数据唯一且极其紧凑的 […]
mkpasswd命令 – 生成用户的新密码--->mkpasswd命令来自英文词组“Make Password”的缩写，其功能是用于生成用户的新密码。mkpas […]
ntp-keygen命令 – 生成NTP主机密钥--->ntp-keygen命令的作用是可以生成NTP主机密钥（公钥和私钥）。 公钥和私有密钥是一对，如果用公开密钥对 […]
slappasswd命令 – 设置LDAP管理员密码--->slappasswd命令的作用是可以生成LDAP管理员密码。 slappasswd命令支持多种加密方案如：CR […]
boot命令 – 启动系统内核或独立程序--->boot 命令是用来引导装入并执行独立程序的过程；一般而言，操作系统内核是独立程序，但是任何独立的程序都是可以 […]
bart命令 -文件完整性扫描和报告--->bart 命令是一个基于规则的文件完整性扫描和报告工具，它使用加密强度的校验和和文件系统元数据来报告变化。 语 […]
asradm命令 – 自动服务请求注册实用程序--->asradm 实用程序由特权系统管理员使用来注册主机，以便在Oracle Sun系统的Oracle自动服务请求 […]
archiveadm命令 –  Solaris 归档文件实用程序--->archiveadm 实用程序为用户提供了创建正在运行的 Oracle Solaris 系统的系统干归档映像的 […]
aimanifest命令 – 修改自动安装程序使用的XML文件--->aimanifest 命令可以创建一个新的 XML 清单或修改一个现有的清单。虽然 aimanifest 可以 […]
zabbix_server命令 – zabbix服务器守护进程--->zabbix_server是Zabbix软件的核心守护进程；获取数据、配置主机、发送邮件等等众多事情都是由za […]
zabbix_sender命令 – zabbix发送器工具--->zabbix_sender 是一个命令行工具，用于向 Zabbix 服务器或代理发送监控数据；在Zabbix服 […]
zabbix_proxy命令 – zabbix代理守护进程--->zabbix_proxy是一个从设备收集监控数据并将其发送到Zabbix服务器的守护进程。 zabbix_pr […]
zabbix_get命令 – zabbix获取数据实用工具--->zabbix_get 是一个命令行工具，用于从 Zabbix 代理获取数据。 zabbix_get 是在ser […]
zabbix_agentd命令 – Zabbix客户端守护程序--->zabbix_agentd 是一个用于监控各种服务器参数的守护进程。 zabbix_agentd是安装到被监控 […]
svnadmin命令 – 管理SVN版本库--->使用svnadmin命令可以管理subversion版本库，比如创建、升级、检验、修复，以及产生即时副本等。  […]
applypatch命令 – 安装或卸载补丁--->applypatch 命令应用由 makepatch 程序生成的补丁包，它将执行以下操作，首先，它将广泛验证补 […]
ansible命令 – 运维自动化工具--->ansible是一款简单的运维自动化工具，只需要使用ssh协议连接就可以来进行系统管理，自动化执行命令，部署等 […]
python命令 – 解释器、交互式、面向对象的编程语言--->Python是一种解释型的、交互式的、面向对象的编程语言，它结合了非凡的功能和非常清晰的语法。Python L […]
lslogins命令 – 显示系统中现有用户的相关信息--->lslogins命令会展示出系统中现有用户的相关信息，-u标记可用来标识只展示用户的账户。 该命令检查wtmp […]
troff命令 – 格式化打印机和字符终端的文本--->troff格式化打印机和字符终端的文本，是 Unix 历史上最重要的软件之一。 像 roff，nroff 和  […]
catman命令 – 创建参考手册的格式化文件--->catman实用程序基于输入文件创建在线手册的预格式化版本。通过此功能，可以轻松地在一组关联的计算机之间分发预 […]
nmtui命令 – 管理网卡配置参数--->nmtui命令来自英文词组“NetworkManager TUI”的缩写，其功能是用于管理网卡配置参数。用户可 […]
msgcat命令 – 合并多个邮件目录--->msgcat命令合并多个邮件目录。msgcat程序连接并合并指定的PO文件。它找到两个或多个指定的PO文件共有 […]
lessecho命令 – 展开元字符--->lessecho是一个简单地在标准输出上重复其参数的程序，但是任何包含空格的参数都要用引号括起来。 语法格式： […]
strip命令 – 从文件中去除指定符号或调试信息--->strip命令的功能是用于从文件中去除指定符号或调试信息，可以针对一般文件与函数库文件进行操作，能够减少文件占 […]
msgen命令 – 创建英文邮件目录--->msgen命令用于创建英文邮件目录。输入文件是最后输入的英文邮件或者一个邮件模板。该命令可以快速生成邮件模板。 […]
aulast命令 – 打印上次登录用户列表--->aulast是一个程序，它打印出上次登录用户列表，类似于last和lastb命令。aulast 搜索审核日志或 […]
auvirt命令 – 显示与虚拟机相关的数据--->auvirt命令显示在审核日志中发现的访客会话列表。如果指定了访客，则仅考虑与该访客相关的事件。若要指定访客， […]
chronyc命令 – 设置时间与时钟服务器同步--->chronyc命令来自英文词组“chrony command-line”的缩写，其功能是用于设置时间与时钟服务 […]
bootctl命令 – 控制固件与systemd-boot引导管理器--->bootctl能够检查 EFI 引导管理器状态、列出可用引导管理器、列出启动项， 还能够在当前系统上安装、更新 […]
factor命令 – 分解因数--->factor命令用于分解因数。 factor是Ubuntu自带的分解质因数的指令，速度飞快。系统自带的fact […]
jot命令 – 创建数字列表--->jot命令可以创建一系列数字。给定数字总数及起始数字即可。可帮助您根据您提供的值创建数字列表，作为起始编号和要 […]
docker-compose命令 – 容器集群的快速编排工具--->docker-compose命令来自英文词组“docker compose”的拼写，其功能是用于容器集群的快速 […]
pdbedit命令 – 管理Samba服务的用户账户--->pdbedit命令来自英文词组“password database editor”的缩写，其功能是用于管理Sa […]
smbtree命令 – 基于文本的SMB网络浏览器工具--->smbtree命令是一款文本模式的smb浏览器程序，它类似于Windows电脑上的 “网络邻居&# […]
sshpass命令 – 非交互式验证SSH密码--->sshpass命令来自英文词组“SSH password”的缩写，其功能是用于非交互式验证SSH密码。SSH是 […]
ifplugstatus命令 – 检查网线是否已插到在网络接口--->ifplugstatus命令可以查看所有网络接口的状态，或是指定网络接口的状态。 这个命令Ubuntu没有预装 […]
gpg命令 – 对信息加密和解密--->gpg命令来自英文词组“GnuPG”的缩写，其功能是用于对信息加密和解密。gpg命令是Linux系统中对信息进 […]
mutter命令 – GTK2窗口管理器--->mutter命令是一款面向非技术用户的最小化X窗口管理器，它被设计成可以与GNOME桌面很好地集成。mutte […]
redis-server命令 – 启动Redis服务程序--->redis-server命令的作用是用于启动Redis服务程序。Redis服务的英文全称为“Remote Di […]
redis-benchmark命令 – Redis基准性能测试--->redis-benchmark命令可以为Redis做基准性能测试，它提供了很多选项帮助开 发和运维人员测试Re […]
redis-cli命令 – redis客户端管理工具--->redis-cli命令来自英文词组“Redis Command-Line Interface”的缩写，其功能是 […]
grub-crypt命令 – 对口令进行加密--->grub-crypt命令的作用是对口令进行加密。grub-crypt命令支持对口令进行MD5和SHA加密，默认 […]
xconfigurator命令 – 设置XFree86--->这是Red Hat公司遵循GPL规则所开发的程序，它具有互动式操作界面，您可以轻易地利用方向键和空格键等，设置 […]
zic命令 – 时区编辑器--->zic是时区编辑器。zic命令从文件中读取文本输入，文件的名字是用命令行指定的；然后生成时间转换信息文件，此文 […]
stratis命令 – 管理linux存储--->stratis 是一个具有与 ZFS 和 Btrfs 相似功能的卷管理文件系统。同时又是一个易于使用的 Lin […]
bccmd命令 – CSR BCCMD接口的实用程序--->bccmd命令是将BlueCore命令发布给Cambridge Silicon Radio设备， 如果不带参数 […]
slrn命令 – 新闻组阅读程序--->slrn是一个很容易使用的新闻组阅读程序，提供全屏幕的图形操作界面，让用户能轻松地阅读与管理新闻组。 语法格式 […]
addr2line命令 – 函数地址解析工具--->addr2line命令来自英文词组“address to line”的缩写，其功能是将函数地址解析成文件名或行 […]
ab命令 – Web服务器的性能测试工具--->ab命令是Apache的Web服务器的性能测试工具，它可以测试安装Web服务器每秒种处理的HTTP请求。 语法 […]
archive命令 – 新闻组文件备存程序--->archive会读取新闻组的文件，然后加以备存。archive备存时，会保存[源文件]中文件的目录阶层。 语法 […]
metamail命令 – 处理非文字E-mail的程序--->metamail命令负责处理非文字E-mail的程序。该命令可以通过参数设置邮件内容类型，寄信人地址，邮件管理 […]
cmatrix命令 – 代码雨风格屏幕保护--->cmatrix命令是一个模拟黑客帝国风格的屏幕保护命令，使用它可以完成可定制的代码雨效果，它可以改变代码下落速 […]
dc命令 – 高精度计算器--->dc命令来自英文词组“Desk Calculator”的缩写，中文译为“桌面计算器”，其功能是用于高精度数字计 […]
sndconfig命令 – 设置声卡--->sndconfig命令用于设置声卡。该命令支持PnP设置，可自动检测并设置PnP声卡。 PnP全称Plug-a […]
shuf命令 – 产生随机的排列--->shuf命令将输入的内容随机排列并输出。 shuf命令当没有文件或文件为-时，读取标准输入。 语法格式: sh […]
shift命令 – 向左移动参数--->shift命令来自英文单词“移动”，其功能是用于向左移动参数。Linux命令能够一次性接收多个参数，可能是0个 […]
mkisofs命令 – 建立ISO 9660映像文件--->mkisofs命令用来将指定的目录与文件做成ISO 9660格式的映像文件，以供刻录光盘。 语法格式: mki […]
tmux命令 – 终端复用软件--->Tmux是一个优秀的终端复用软件，类似GNU Screen，但来自于OpenBSD，采用BSD授权. 使用它最 […]
eval命令 – 重新运算求出参数--->eval命令用于重新运算求出参数的内容。eval可读取一连串的参数，然后再依参数本身的特性来执行。 语法格式: […]
mkinitrd命令 – 建立ramdisk映像文件--->mkinitrd命令建立要载入ramdisk的映像文件，以供Linux开机时载入ramdisk。 这个是重新封 […]
break命令 – 结束for while或until循环--->break命令用于结束for，while或until循环，可指定退出几层循环。 语法格式：break [参数] […]
continue命令 – 结束本次循环--->continue主要用途在于结束本次循环，继续执行下一个for，while或until循环；可指定从第几层循环 […]
named-checkzone命令 – 检查和转换--->named-checkzone命令可以进行区域文件有效性检查和转换，必须指定区域名称和区域文件名称。 语法格式 […]
rake命令 – ruby程序构建--->rake是一个简单的ruby构建程序，其功能类似于常规make命令。 rake具有以下特性：1、rakefil […]
command命令 – 调用并执行指定的命令--->command命令来自英文单词“命令”，其功能是用于调用并执行指定的命令。当系统同时定义了与命令相同的函数时， […]
pv命令 – 管道查看器--->pv命令来自于英文词组”Pipe viewer“的缩写，其功能是用于管道查看器。pv命令能够通过管道显示数据处 […]
pstack命令 – 显示进程的栈跟踪信息--->pstack命令来自英文词组“process stack”的缩写，其功能是用于显示进程的栈跟踪信息。pstac […]
pigz命令 – 多线程的解压缩文件--->pigz命令来自英文词组“parallel implementation of gzip”的缩写，其功能是用于 […]
php命令 – PHP语言的命令行接口--->php命令是流行的Web开发语言PHP的命令行接口，可以使用PHP语言开发基于命令行的系统管理脚本程序。 使用 […]
setsid命令 – 新会话中运行程序--->setsid命令子进程从父进程继承了：SessionID、进程组ID和打开的终端。子进程如果要脱离这些，代码中 […]
xlsclients命令 – 列出应用程序--->xlsclients命令用来列出显示器中的客户端应用程序。 语法格式：xlsclients [参数] 常用参数 […]
xlsatoms命令 – 列出原子成分--->xlsatoms命令用于列出X服务器内部所有定义的原子成分，每个原子成分都有自身的编号。可利用参数设置列表范围 […]
vgreduce命令 – 删除物理卷--->vgreduce命令通过删除LVM卷组中的物理卷来减少卷组容量。不能删除LVM卷组中剩余的最后一个物理卷。 语 […]
vdfuse命令 – 挂载分区文件工具--->vdfuse命令是VirtualBox软件挂载VDI分区文件的一个工具，VirtualBox是一款能创建虚拟机 […]
users命令 – 显示当前登录的用户--->users命令用于显示当前登录系统的所有用户的用户列表。每个显示的用户名对应一个登录会话。如果一个用户有不止一 […]
unexpand命令 – 空白字符转换--->unexpand命令用于将给定文件中的空白字符（space）转换为制表符（TAB），并把转换结果显示在标准输出 […]
killall5命令 – 向所有进程发送信号--->killall5是SystemV killall命令。它向所有进程发送一个信号，除了内核线程和它自己会话中的进 […]
seq命令 – 打印数字序列--->seq命令用于以指定增量从首数开始打印数字到尾数，即产生从某个数到另外一个数之间的所有整数，并且可以对整数的格 […]
times命令 – 显示进程累计时间--->打印出shell及其子进程累计使用的用户时间和系统时间。 总是返回成功。 语法格式：times [参数] 参考 […]
protoize命令 – 添加函数原型--->protoize命令属于gcc套件，用于为C语言源代码文件添加函数原型，将GNU-C代码转换为ANSI-C代码 […]
builtin命令 – 执行bash内建命令--->builtin命令用于执行指定的bash内建命令， builtin命令调用的bash内建命令优先于同名的外部命 […]
script命令 – 记录终端交互会话过程--->script命令可以用作交互终端会话过程的记录，保留用户输入和系统输出的全过程。以备之后查询与学习，对于初学者 […]
trap命令 – 指定采取的动作--->trap命令用于指定在接收到信号后将要采取的动作，常见的用途是在脚本程序被中断时完成清理工作。当shell接收 […]
tcpreplay命令 – 性能或功能测试--->tcpreplay 是一种pcap包的重放工具，它可以将用ethreal、wireshark工具抓下来的包原样 […]
write命令 – 发送信息--->write命令用于向指定登录用户终端上发送信息。通过write命令可传递信息给另一位登入系统的用户，当输入完毕 […]
wget命令 – 下载网络文件--->wget命令来自英文词组“web get”的缩写，其功能是用于从指定网址下载网络文件。wget命令非常稳定，一 […]
whatis命令 – 查询命令执行功能--->whatis命令是用于查询一个命令执行什么功能，并将查询结果打印到终端上。 whatis命令在用catman  […]
wall命令 – 输出信息--->wall命令用于向系统当前所有打开的终端上输出信息。通过wall命令可将信息发送给每位同意接收公众信息的终端机 […]
wait命令 – 等待指令执行完毕--->wait命令的功能是用于等待指令执行完毕，常被用于Shell脚本中，用于等待某个指令执行结束后返回终端，然后才 […]
volname命令 – 显示设备卷名称--->volname命令用于显示指定的“ISO-9660”格式的设备的卷名称，通常这种格式的设备为光驱。 语法格式： […]
vgscan命令 – 扫描并显示卷组--->vgscan命令查找系统中存在的LVM卷组，并显示找到的卷组列表。vgscan命令仅显示找到的卷组的名称和LV […]
vgrename命令 – 重命名卷组--->在Linux下使用新硬盘安装系统，安装好以后再挂载原来的硬盘，分区格式全为系统默认分区，系统默认使用的是lvm […]
xargs命令 – 给其他命令传参数的过滤器--->xargs命令来自英文词组“extended arguments”的缩写，其功能是用于给其他命令传递参数的过滤 […]
test命令 – 检查条件是否成立--->test命令来自英文单词“测试”，其功能是用于检查条件是否成立，能够对数值、字符和文件进行条件测试。Linux […]
printf 命令 – 格式化输出信息--->printf命令来自英文词组“format and print”的缩写，其功能是用于格式化输出信息。Linux […]
xz命令 – POSIX 平台开发工具--->XZ Utils 是为 POSIX 平台开发具有高压缩率的工具。它使用 LZMA2 压缩算法，生成的压缩文件比 […]
history命令 – 显示与管理历史命令记录--->history命令来自英文单词“历史”，其功能是用于显示与管理历史命令记录。Linux系统默认会记录用户所执行 […]
exportfs命令 – 管理NFS服务器共享的文件系统--->exportfs命令需要参考配置文件“/etc/exportfs”。也可以直接在命令行中指定要共享的NFS文件 […]
declare命令 – 声明定义新的变量--->declare命令来自英文单词“宣布、声明”，其功能是用于声明定义新的变量。使用declare命令新创建的变量 […]
jobs命令 – 显示终端后台的作业信息--->jobs命令来自英文单词“工作”，其功能是用于显示终端后台的作业信息。Linux系统运维人员可以使用jobs命 […]
popd命令 – 从shell目录堆栈中删除记录--->用于从Shell目录堆栈中删除记录，如果不加任何选项，popd命令先删除Shell目录堆栈栈顶的记录，再把当前 […]
pushed命令 – 向shell目录堆栈中添加记录--->pushed命令用于将目录加入堆栈中，加入记录到目录栈顶部，并切换到该目录，如果不加任何参数， 则会将位于记录 […]
fc命令 – 编辑并执行历史命令--->EXTENDED_HISTORY环境变量影响fc命令的执行，如果变量设置为ON，则记录时间，否则不记录时间。  […]
shopt命令 – 设置控制shell行为变量的开关--->shopt命令可以设置哪些控制着Shell行为特性的变量的开关值，以达到控制Shell行为的目的。当执行命令s […]
hash命令 – 管理命令运行时查询的哈希表--->hash命令来自英文词组“Hash Algorithm”的缩写，中文译为哈希算法或杂凑算法，其功能是用于管理命 […]
dirs命令 – 显示Shell目录堆栈中的记录--->dirs命令用于显示Shell目录中的堆栈记录。不加选项时显示当前的Shell命令堆栈中的所有目录，显示时左边 […]
rmmod命令 – 移除内核模块--->rmmod命令来自英文词组“remove module”的缩写，其功能是用于移除内核模块。Linux操作系统的 […]
bc命令 – 数字计算器--->bc命令来自英文词组“Binary Calculator”的缩写，中文译为二进制计算器，其功能是用于数字计算。 […]