metarename命令 -重命名元组件或切换分层元组件名称--->重命名元组件或切换分层元组件名称 语法格式：metarename[参数] 常用参数： -f 强制转换跨元设备成 […]
metareplace命令 – 启用或替换子镜像或RAID5元设备的组件--->metareplace命令用于启用或子镜像或RAID5元设备内更换组件（片）。 语法格式：metareplac […]
metassist命令 – 支持Solaris Volume Manager的自动卷创建实用程序--->metassist命令通过自动化提供使用常见Solaris卷管理器任务的帮助。 语法格式：metassist[ […]
metattach命令 – 附加或分离元设备--->metattach将子镜像添加到镜像，增长元设备或增长软分区。无需中断服务即可完成元设备的增长。 语法格式：m […]
mkbootmedia命令 – 创建可引导的Solaris ISO映像--->mkbootmedia实用程序以媒体根(磁盘上Solaris安装媒体的根)作为输入，并使用mkisofs在文件 […]
metainit命令 – 配置元设备--->metainit命令根据命令行上指定的信息配置元组件和热备用。或者，你可以运行metainit，让它使用你在/ […]
mkdumprd命令 – 为内核转储崩溃恢复初始ramdisk映像--->mkdumprd命令的作用是创建一个初始ram文件系统，用于在kdump框架中引导内核以进行崩溃恢复。 在初始 […]
metaparam命令 – 修改元设备的参数--->metaparam命令用于显示或修改元数据的当前参数。如果仅将metadevice指定为metaparam命令 […]
metarecover命令 – 恢复软分区信息--->metarecover命令扫描指定的组件以查找软分区配置信息并重新生成配置。 语法格式：metarecover […]
sharectl命令 – 配置和管理文件共享服务--->sharectl命令对文件共享协议进行操作，如NFS和SMB。该命令可以设置客户端和服务器的操作属性，获取和恢 […]
auditstat命令 -显示内核审计统计--->auditstat 命令用来显示内核审计统计信息，统计用户级审计所处理的审计记录数、已被删除的审计记 […]
bootadm命令 – 管理引导配置--->bootadm 命令管理启动存档，对于 x86 的启动环境，管理 GRUB（GRand Unified Boo […]
metaimport命令 – 将磁盘集导入到现有的Solaris Volume Manager配置中--->metaimport命令允许将磁盘集(包括复制的磁盘集)导入到现有的Solaris卷管理器配置中。复制磁盘集是 […]
metaclear命令 – 删除活动的元设备和热备用池--->metaclear命令删除指定的metadevice或hot_spare_pool，或清除指定组件中的所有软分 […]
xsetroot命令 – 根窗口参数设置实用程序--->xsetroot命令允许您在运行X的工作站显示器上定制背景（根）窗口的外观。通常，您可以尝试使用xsetroo […]
firewall-offline-cmd命令 – 防火墙脱机客户端--->firewall-offline-cmd命令来自英文词组“Firewall offline cmd”的拼写，其 […]
lslk命令 – 列出本地锁--->lslk命令的作用是可以列出本地inode上的文件锁的信息。 锁可以属于本地系统上的进程，也可以属于本地系统是 […]
fgconsole命令 – 显示活动的虚拟终端数量--->fgconsole命令的作用是可以显示活动的虚拟终端数量。 如果活动的虚拟终端为/dev/ttyN，则在标准输 […]
tset命令 – 终端初始化--->tset命令的作用是可以进行终端初始化。默认终端类型为“unknown”。 如果命令行上没有指定终端类型，则应 […]
nsupdate命令 – 动态DNS更新工具--->nsupdate实用程序用于向名称服务器提交 RFC2136 中定义的动态 DNS 更新请求。这允许在无需手动 […]
timedatectl命令 – 设置系统时间与日期--->timedatectl命令来自英文词组“time date control”的缩写，其功能是用于设置系统时间与 […]
netplan命令 – 网络参数配置工具--->netplan命令来自英文词组“Network Plan”的缩写，其功能是用于修改网卡信息，是一款网络参数配置 […]
tzselect命令 – 查看设置时区--->tzselect命令在调用时不需要任何参数，它显示了一个由十几个地理区域组成的列表，人们可以粗略地将其视为大陆 […]
mandb命令 – 创建或更新手册页索引缓存--->mandb命令用于初始化或手动更新通常由man维护的索引数据库缓存，缓存包含与手动页面系统的当前状态相关的信息 […]
localectl命令 – 控制系统的本地化与键盘布局--->localectl命令可用于查询与修改系统的本地化(locale)与键盘布局的设置。 它通过与systemd- […]
sosreport命令 – 收集并打包诊断和支持数据--->sosreport命令从正在运行的系统生成配置和诊断信息的存档。存档文件可以存储在本地或集中，以便记录或跟踪， […]
sestatus命令 – 显示SELinux状态--->sestatus命令的作用是可以查看系统运行SELinux的状态，应用模式、布尔值，以及显示/etc/sest […]
semodule命令 – 管理SELinux策略模块--->semodule命令来自英文词组“Manage SELinux policy modules”的缩写，其功能是 […]
taskset命令 – 绑定进程与CPU核心--->taskset命令来自英文词组“task set”的缩写，其功能是用于绑定进程与CPU核心。常见情况下，一个服 […]
aulastlog命令 – 打印最近登陆记录--->aulastlog是一个程序，它打印出计算机的所有用户的最后一个登录名，并使用类似于lastlog命令的方式， […]
chmem命令 – 设置内存--->chmem命令将特定大小或范围的内存设置为联机或离线。当设置内存联机时，chmem从最低内存块开始数字。当设置 […]
lssubsys命令 – 列出包含指定子系统的层次结构--->lssubsys命令的作用是可以列出包含指定子系统的层次结构。 如果未定义子系统，那么将显示所有已安装的层次结 […]
iscsiadm命令 – ISCSI服务管理工具--->iscsiadm命令来自英文词组“ISCSI administration”的缩写，是最常用的ISCSI服务管 […]
vnstat命令 – 查看网卡流量使用情况--->vnstat命令的功能是用于查看网卡流量使用情况，是一个基于控制台的网络流量监控器。使用vnstat命令能够按 […]
cloud-init命令 – 跨平台云实例初始化工具--->cloud-init命令是用于跨平台云实例初始化的行业标准多分布式方法，所有主要的公共云提供商、私有云基础设施 […]
iperf3命令 – 进行网络吞吐量测试--->iperf3是一款进行网络吞吐量测试的命令工具，由美国伊利诺伊大学研发和维护。在建立好客户端和服务器后，ipe […]
chrt命令 – 实时管理进程的优先级策略--->chrt命令来自英文词组“Change real-time”的缩写，其功能是用于实时管理进程的优先级策略，策略 […]
deluser命令 – 删除用户账户--->deluser命令来自英文词组“delete user”的缩写，其功能是用于删除用户账户。 语法格式：delu […]
lsns命令 – 列出名称空间--->lsns命令列出有关所有当前可访问的名称空间或给定名称空间的信息。命名空间标识符是一个索引节点号。 语法格式： […]
ufw命令 – 管理防火墙服务--->ufw命令来自英文词组“Uncomplicated Firewall”的缩写，中文译为简单防火墙，其功能是用于 […][重]
journalctl命令 – 检索systemd日志--->journalctl命令可以用来查询 systemd-journald.service(8) 所写的 syst […]
timeout命令 – 在指定的时间应在运行则杀死该进程--->timeout命令作用是运行指定命令，如果在指定时间后在运行则杀死该进程。 timeout命令是GNU核心实用 […]
initctl命令 – 管理init守护进程--->initctl命令来自英文词组“init control”的缩写，其功能是用于管理init守护进程。init作 […]
esxcfg-vswitch命令 – ESX虚拟交换机管理工具--->esxcfg命令集分为网络管理类、存储管理类、系统管理类等几种类型，esxcfg-vswitch命令是负责网络 […]
rht-vmctl命令 – 控制虚拟机系统--->rht-vmctl命令来自英文词组“redhat vmware control”的缩写，其功能是用于控制虚拟机 […]
vim-cmd命令 – 控制虚拟机状态--->vim-cmd命令的功能是用于控制虚拟机状态。vim-cmd是esxi命令行，可在命令行下控制虚拟机的注册，启 […]
esxcfg-advcfg命令 – 配置主机--->esxcfg命令集分为网络管理类、存储管理类、系统管理类等几种类型，esxcfg-advcfg负责配置主机，设 […]
anacron命令 – 定期运行命令--->anacron命令可用于定期执行命令，频率以天为单位指定，与cron（8）不同的是，它不假定机器连续运行。因此 […]
virsh命令 – 管理虚拟机系统--->virsh命令来自英文词组“virtualization shell”的缩写，中文译为虚拟化终端，其功能是用于 […]
apmsleep命令 – 进入暂停或待机模式，稍后唤醒--->apmsleep命令是使计算机进入备用或者修复状态，一些计算机，特别是笔记本电脑，可以使用实时时钟（RTC）芯 […]
brctl命令 – 管理以太网网桥--->brctl命令来自英文词组“bridge control”的缩写，其功能是用于管理以太网网桥。brctl命令能 […]
pacman命令 – 软件包管理器--->pacman命令来自英文词组“package manager”的缩写，其功能是用于管理软件包。pac […]
compgen命令 – 列出所有Linux命令--->compgen一个很棒的命令列出所有Linux命令，compgen是bash内置命令，它将显示所有可用的命令， […]
complete命令 – 自动补全声明--->complete命令是声明对于每一个NAME名称如何完成读取参数。如果不带选项，现有的补全声明会以可以重用为输 […]
XF86Setup命令 – 设置XFee86--->这是Linux系统用来设置XFee86的程序，它会进入图形模式，通过互动操作界面，让用户轻松完成XFee86环 […]
tsar命令 – 收集服务器系统信息--->tsar是淘宝自己开发的一个采集工具（类似于sar工具），主要用来收集服务器的系统信息（如cpu，io，mem […]
lpd命令 – 常驻的打印机管理程序--->lpd命令是一个常驻的打印机管理程序，它会根据 /etc/printcap 的内容来管理本地或远端的打印机。这 […]
zenity命令 – 显示图形框--->zenity命令的功能是用于显示图形框，允许运维人员调用各种Shell终端的弹窗信息，可以查看日历，消息，亦可 […]
yum-groups-manager命令 – 创建和编辑yum的组元数据--->yum groups manager用于创建或编辑yum存储库的组元数据文件；这通常比书面形式要容易得多手工编 […]
yumdownloader命令 – 从Yum存储库下载软件包--->yumdownloader命令来自英文词组“Yum downloader”的拼写，其功能是用于从Yum存储库下 […]
yum-builddep命令 – 安装缺少的依赖软件包--->yum-builddep命令来自英文词组“yum build depend”的缩写，其功能是用于安装缺少的依赖 […]
yum-debug-restore命令 – 重播在调试转储文件中捕获的yum事务--->yum debug restore是一个程序，它接受由yum debug dump创建的gzip文件，并对其中 […]
yum-config-manager命令 – 管理软件仓库--->yum-config-manager命令的功能是用于管理软件仓库，可以调整yum的主要配置参数，启动或关闭指定 […]
rpmlint命令 – 检查rpm软件包中的常见错误--->rpmlint命令的作用是可以检查rpm软件包中常见的错误。使用rpmlint命令需要先安装rpmlint软件 […]
yum-complete-transaction 命令 – 尝试完成系统上不完整或中止的yum事务进程--->yum-complete-transaction命令的作用是在系统上查找不完整或中止的yum事务进程并尝试完成 […]
yumdb命令 – 查询和修改yum数据库--->yumdb命令的作用是查询和更改yum数据库，yum数据库是与rpm数据库结合使用的。任何已安装的包都可以在y […]
update-alternatives命令 – 维护系统命令链接符--->update-alternatives是Debian系统中专门维护系统命令链接符的工具，通过它可以很方便的设置 […]
ipstat命令 – 实时显示 Linux 内核中 iptables 的工作状态--->ipstat 命令用于根据命令语法中指定的所选输出模式和排序顺序收集并报告有关服务器上 IP 通信流 […]
setup命令 – 系统管理工具--->setup命令是一个基于文本界面的系统管理工具，集成了用户认证管理、防火墙管理、网络管理和系统服务管理。 语法 […]
liloconfig命令 – 设置核心载入--->liloconfig命令用于设置核心载入，开机管理程序。 liloconfig是Slackware发行版专门用 […]
ctrlaltdel命令 – 设置Ctrl+Alt+Del组合键的功能--->ctrlaltdel命令来自英文词组“control alter delete”的缩写，其功能是用于设置Ctr […]
mkbootdisk命令 – 建立启动盘--->mkbootdisk命令用来为当前运行的系统创建能够单独使用的系统引导软盘，以便在系统出现故障时能够启动操作进 […]
htop命令 – 互动的进程查看器--->htop是linux系统中的一个互动的进程查看器，一个文本模式的应用程序(在控制台或者X终端中)，需要ncur […]
grub命令 – 交互式的管理GRUB引导程序--->grub命令的功能是用于交互式地管理GRUB引导程序。GRUB是一个系统引导程序，可以服务于Linux、Win […]
ldconfig命令 – 动态链接库管理命令--->ldconfig命令的作用主要是在默认搜寻目录/lib和/usr/lib以及动态库配置文件/etc/ld.so […]
set命令 – 显示与设置Shell变量信息--->set命令的功能是用于显示与设置Shell变量信息，管理员亦可以用该命令设置Shell终端特性，更好符合日常工 […]
printenv命令 – 显示系统环境变量与值--->printenv命令来自英文词组“print environment”的缩写，其功能是用于显示系统环境变量与值 […]
ntpdate命令 – 设置日期和时间--->ntpdate命令来自英文词组”NTP date“的拼写，其功能是用于设置日期和时间。ntpdate命令能够基 […]
tabs命令 – 在终端上设置选项卡--->tabs程序清除并设置终端上的制表位。这使用terminfo清除所有选项卡和设置选项卡功能。如果其中一个不存在 […]
logger命令 – 系统日志记录--->logger是一个shell命令接口，可以通过该接口使用Syslog的系统日志模块，还可以从命令行直接向系统日 […]
loginctl命令 – 控制systemd登录管理器--->loginctl命令可用于检查和控制systemd的状态；查看已经登录的用户会话消息。 语法格式：loginc […]
locale命令 – 设置字符集--->locale是linux系统中多语言环境的设置接口，Locale根据计算机用户所使用的语言，所在国家或者地区， […]
dnf命令 – 新一代的软件包管理器--->dnf命令来自英文词组“Dandified YUM”的缩写，是新一代的软件包管理器，其功能是用于安装、更新、卸 […]
disown命令 – 从Shell终端中移除作业--->disown命令的功能是用于从Shell终端中移除作业，是一个bash解释器的内置命令。disown命令能够从 […]
fuser命令 – 使用文件或文件结构识别进程--->fuser命令作用是报告进程使用的文件和网络套接字。 fuser命令可以显示出当前哪个程序在使用磁盘上的某个文 […]
ipcrm命令 – 移除一个消息对象、共享内存段或信号集--->ipcrm命令用来删除一个或更多的消息队列、信号量集或者共享内存标识。 语法格式：ipcrm [参数] 常用参 […]
dstat命令 –  全能系统信息统计工具--->dstat命令是一个用来替换vmstat、iostat、netstat、nfsstat和ifstat这些命令的 […]
glances命令 – 高层次的多子系统概览--->Linux系统自带了很多系统性能监控工具，如top，vmstat，iftop等等，还有一款监视工具glance […]
lshw命令 – 查看硬件设备信息--->lshw命令来自英文词组“list hardware”的缩写，其功能是用于查看硬件设备信息。lshw命令能够显 […]
testparm命令 – 测试Samba的设置是否正确无误--->testparm命令用于测试Samba的设置是否正确无误，执行testparm(test parameter) […]
atq命令 – 显示用户待执行任务列表--->atq命令的作用是显示系统中待执行的任务列表。 任务列表中的任务由at命令和batch命令创建，显示内容包括任 […]
atrm命令 – 删除待执行的任务--->atrm命令的作用是删除待执行任务队列中的指定任务。 通常，先使用atq命令查询待执行任务列表以显示任务号，再 […]
grpunconv命令 – 关闭群组的投影密码--->grpunconv命令关闭群组的投影密码, 执行grpunconv指令可关闭群组投影密码，它会把密码从gsha […]
grpconv命令 – 开启群组的投影密码--->grpconv命令用于开启群组的投影密码。 Linux系统里的用户和群组密码，分别存放在/etc目录下的pas […]
pwconv命令 – 开启用户的投影密码--->pwconv命令用来开启用户的投影密码。Linux系统里的用户和群组密码，分别存放在名称为passwd和gro […]
openssl命令 – 加密算法--->openSSL是一个强大的安全套接字层密码库，囊括主要的密码算法、常用的密钥和证书封装管理功能及SSL协议，并 […]
sh命令 – shell命令语言解释器--->sh命令来自英文单词“shell”的缩写，其功能是Shell命令语言的解释器。sh其实并不是一个实际存在的命令 […]
findfs命令 – 依据卷标（Label）和UUID查找文件系统所对应的设备文件--->findfs命令依据卷标（LABEL）和UUID查找文件系统所对应的设备文件。 语法格式：findfs [参数 […]
package-cleanup命令 –  清理本地安装的RPM软件包--->package-cleanup 清理本地安装的、重复的或孤立的的RPM软件包，这是一个只对RPM有用的工具，U […]
logwatch命令 – 遍历系统日志--->logwatch命令是一个可定制和可插入式的日志监视系统，它通过遍历给定时间范围内的系统日志文件而产生日志报告 […]
getsebool命令 – 查询SElinux策略内各项规则的布尔值--->getsebool命令是用来查询SElinux策略内各项规则的布尔值。 语法格式：getsebool [参数] […]
mapfile命令 –  从标准输入读取行并赋值到数组--->mapfile命令用于从标准输入或文件描述符读取行并赋值到数组 语法格式： mapfile [参数] 常用参数 […]
xinit命令 – X服务器初始化程序--->xinit命令是Linux下X-Window系统的初始化程序，主要完成X服务器的初始化设置。 语法格式：xin […]
setsebool命令 – 修改布尔值--->setsebool命令是用来修改SElinux策略内各项规则的布尔值。 语法格式：setsebool [参数] […]
groups命令 – 显示用户组信息--->groups命令来自英文单词“群组”，其功能是用于显示用户组信息。Linux系统中的用户组信息保存在/etc/ […]
grpck命令 – 验证文件的完整性--->使用grpck命令检查数据是否正确存放，每条记录是否都包含足够的信息，是否有一个唯一的组名，是否包含正确的用户 […]
pwck命令 – 验证系统认证文件--->使用pwck命令用来验证系统认证文件/etc/passwd和/etc/shadow的内容和格式的完整性。 语法 […]
restorecon命令 – 恢复文件安全上下文--->restorecon命令来自英文词组“restore config”的缩写，其功能是用于恢复文件安全上下文。安 […]
sesearch命令 – 查看SElinux策略--->使用seinfo命令可以查询SELinux的策略提供多少相关规则，如果查到的相关类型或者布尔值，想要知道详细规 […]
sha1sum命令 –  查看效验文件哈希值命令--->sha1sum命令用于生成和校验文件的sha1值。它会逐位对文件的内容进行校验。是文件的内容，与文件名无关，也 […]
size命令 – 显示文件各段大小--->size命令来自英文单词，中文译为“大小”，其功能是用于显示文件各段大小。size命令是GNU二进制工具集中的 […]
journalctl命令 – 查看指定的日志信息--->journalctl命令来自英文词组“journal control”的缩写，其功能是用于查看指定的日志信息。 […]
getenforce命令 – 显示SELinux服务模式--->getenforce命令来自英文词组“get the current mode of SELinux”的拼写， […]
setenforce命令 – 设置SELinux服务状态--->setenforce命令来自英文词组“set enforce”的拼写，其功能是用于设置SELinux服务状态。 […]
postconf命令 – 显示main.cf配置参数的值--->命令显示main.cf配置参数的值，并警告可能是参数名类型错误（Postfix 2.9及更高版本）。它还可以更 […]
createrepo命令 – 创建软件仓库及生成元数据--->createrepo命令来自英文词组“create repository”的缩写，其功能是用于创建软件仓库及生 […]
iconv命令 – 转换文件编码--->iconv命令是 Linux 系统自带的用于转换文件编码的命令行工具。 语法格式：iconv [参数] 常用参 […]
pkill命令 – 依据进程名杀死指定进程--->pkill命令来自英文词组“process kill”的缩写，其功能是依据进程名杀死指定进程。pkill命令与 […]
bmodinfo命令 – 显示给定模块的详细信息--->bmodinfo命令用于显示给定模块的详细信息。 语法格式：bmodinfo [参数] [模块名] 常用参数： […]
clockdiff命令 – 检测两台linux主机的时间差--->在ip报文的首部和ICMP报文的首部都可以放入时间戳数据。 clockdiff 程序正是使 […]
kernelversion命令 – 打印内核主版本号--->kernelversion命令用于打印当前内核的主版本号。 kernelversion命令仅能输出当前内核的主 […]
xset命令 – X-Window系统的用户爱好设置--->xset命令是设置X-Window系统中的用户爱好的实用工具。 xset是上层应用程序，主要用于在X-Wind […]
pidof命令 – 查找服务进程的PID号码--->pidof命令来自英文词组“Process identifier of”的缩写，其功能是用于查找服务进程的PI […]
runlevel命令 – 显示系统的运行级--->runlevel命令是读取/var/run/utmp/文件或指定的其他文件，检索其中最近的运行级记录，显示系统 […]
pgrep命令 – 检索进程PID号码--->pgrep命令来自英文词组“process global regular expression print”的 […]
pmap命令 – 显示进程的内存映像信息--->pmap命令来自英文词组“process memory map”的缩写，其功能是用于显示进程的内存映像信息。p […]
iostat命令 – 监视系统I/O设备使用情况--->iostat命令来自英文词组“I/O stat”的缩写，其功能是用于监视系统I/O设备使用情况。I/O英文全称 […]
enable命令 – 启动或关闭 shell 内建指令--->enable命令可以用于启动或关闭 shell 的内建指令。 如要执行的文件名称与shell内建指令相同，可用 […]
vigr命令 – 修改group、gshadow文件--->vigr命令可以修改group、gshadow文件，使用vigr命令可以编辑/etc/group文件。当寻找一 […]
lvremove命令 – 删除指定LVM逻辑卷--->lvremove命令用于删除指定LVM逻辑卷。如果逻辑卷已经使用mount命令加载，则不能使用lvremove […]
syslog命令 – 系统默认的日志守护进程--->syslog 是Linux系统默认的日志守护进程。默认的syslog配置文件是/etc/syslog […]
iptables-save命令 – 保存防火墙策略规则--->iptables-save命令来自英文词组“iptables save”的拼写，其功能是用于保存防火墙配置规则 […]
consoletype命令 – 输出已连接的终端类型--->consoletype命令用于打印已连接的终端类型到标准输出，并能够检查已连接的终端是当前终端还是虚拟终端。  […]
hostid命令 – 用来打印当前主机的数字化标识--->hostid命令 用于打印当前主机的十六进制数字标识。是主机的唯一标识，是被用来限时软件的使用权限，不可改变。 […]
ip6tables-restore命令 – 还原ip6tables表--->ip6tables-restore命令用来还原ip6tables表。 语法格式：ip6tables-resto […]
iptables-restore命令 – 还原防火墙的表配置--->iptables-restore命令来自英文词组“iptables restore”的拼写，其功能是用于还原防 […]
ip6tables-save命令 – 保存ip6tables表配置--->ip6tables-save命令用来保存ip6tables表配置。 语法格式：ip6tables-save [ […]
ip6tables命令 – IPv6防火墙策略管理工具--->ip6tables命令来自英文词组“ipv6 iptables”的缩写，其功能是用于Ipv6级别的防火墙策略管 […]
supervisord命令 – 配置后台服务/常驻进程的进程工具--->supervisor是一个用 Python 写的进程管理工具，可以很方便的用来在 UNIX-like 系统（不 […]
telint命令 – 切换运行等级--->telint命令用于切换当前正在运行的Linux系统的运行等级。 语法格式：telint [参数] 常用参数： […]
time命令 – 指令执行时所消耗的时间--->time命令的用途，在于量测特定指令执行时所需消耗的时间及系统资源等消息。 例如 CPU 时间、记忆体、输入输 […]
timeconfig命令 – 设置时区--->timeconfig命令用于设置时区， 是Red Hat公司遵循GPL规则所开发的程序，它具有互动式操作界面， […]
nice命令 – 调整进程的优先级--->nice命令的功能是用于调整进程的优先级，合理分配系统资源。Linux系统后台工作中某些不重要的进程，例如定期 […]
at命令 – 一次性定时计划任务--->at命令的功能是用于设置一次性定时计划任务，是Linux系统中常用的计划任务工具之一，会以atd守护进程的形式 […]
uustat命令 – 显示UUCP目前的状况--->执行uucp与uux指令后，会先将工作送到队列，再由uucico来执行工作。uustat可显示，删除或启动队列 […]
fsck.ext2命令 – 检查及修复ext2文件系统--->当ext2文件系统发生错误时，可用fsck.ext2指令尝试加以修复。 语法格式：fsck.ext2 [参数] […]
skill命令 – 送讯号给正在执行的程序--->skill命令送个讯号给正在执行的程序，预设的讯息为 TERM (中断)，较常使用的讯息为 HUP、INT、K […]
nfsstat命令 – 列出NFS统计信息--->nfsstat命令显示关于nfs客户机和服务器活动的统计信息。 语法格式：nfsstat [参数] 常用参数： […]
seinfo命令 – 查询SELinux策略规则--->seinfo命令是用来查询SELinux的策略提供多少相关规则，一个主体进程能否读取到目标文件资源的重点是在于 […]
env命令 – 显示和定义环境变量--->env命令来自英文单词“environment”的缩写，其功能是用于显示和定义环境变量。为了能够让每个用户都拥 […]
tune2fs命令 – 管理文件系统参数--->tune2fs命令来自英文词组“adjust tunable filesystem parameters”的缩 […]
ssh-agent命令 – ssh密钥管理器--->ssh-agent命令是一种控制用来保存公钥身份验证所使用的私钥的程序。ssh-agent在X会话或登录会话之 […]
ssh-copy-id命令 – 复制SSH公钥到远程主机--->ssh-copy-id命令来自英文词组“ssh copy id”，中文译为“复制SSH信息”，其功能是用于将本 […]
ssh-add命令 – agent的高速缓存--->ssh-add命令是把专用密钥添加到ssh-agent的高速缓存中。该命令位置在/usr/bin/ssh-ad […]
type命令 – 查看命令类型--->type命令来自英文单词“类型”，其功能是用于查看命令类型，如需区分某个命令是Shell内部指令还是外部命令， […]
chsh命令 – 更改使用者shell设定--->chsh用于更改登录shell；如果命令行上没有给定shell，chsh将提示输入一个shell。 chsh命 […]
hostname命令 – 显示和设置系统的主机名--->hostname命令的功能是用于显示和设置系统的主机名，Linux系统中的HOSTNAME环境变量对应保存了当 […]
chkconfig命令 – 管理服务程序--->chkconfig命令来自英文词组“Check config“的缩写，其功能是用于管理服务程序。chkconf […]
ssh-keygen命令 – 生成SSH密钥文件--->ssh-keygen命令来自英文词组“SSH key generate”的缩写，其功能是用于生成SSH密钥文件 […]
service命令 – 管理系统服务--->service命令的功能是用于管理系统服务，是早期红帽公司Linux系统中最常见的命令之一，主要应用于RHEL […]
logsave命令 – 将输出信息保存到指定的日志文件中--->logsave程序将使用指定的参数执行cmd_prog，并将其输出的副本保存到logfile。如果日志文件的包 […]
sar命令 – 统计系统运行状态--->sar命令来自英文词组“System activity reporter”的缩写，其功能是用于统计系统运行状态 […]
iotop命令 – 监视磁盘I/O状态--->iotop命令是一个用来监视磁盘I/O使用状况的top类工具。iotop具有与top相似的UI，其中包括PID […]
lsb_release命令 – 查看LSB版本信息--->lsb_release命令来自英文词组“Linux Standard Base release”的缩写，其功能 […]
mtr命令 – 网络诊断--->mtr在单个网络诊断工具中结合了traceroute和ping程序的功能。当mtr启动时，它调查运行在主机mt […]
depmod命令 – 生成模块映射文件--->depmod命令可产生模块依赖的映射文件，在构建嵌入式系统时，需要由这个命令来生成相应的文件，depmod命令 […]
arch命令 – 显示主机硬件架构类型--->arch命令来自英文单词“architecture”的缩写，中文译为“架构”，其功能是用于显示主机硬件架构类型 […]
xauth命令 – 管理X服务器的访问授权--->xauth命令来自英文词组“X authority”的缩写，其功能是用于管理X服务器的访问授权，能够显示和编辑 […]
startx命令 – 初始化X-windows系统--->startx命令来自英文词组“start X-windows”的缩写，其功能是用于启动X-Windows系统。 […]
sysctl命令 – 配置系统内核参数--->sysctl命令来自英文词组“system control”的缩写，其功能是用于配置系统内核参数。sysctl […]
modprobe命令 – 内核模块智能加载工具--->modprobe命令用于智能地向内核中加载模块或者从内核中移除模块。 modprobe命令可载入指定的个别模块 […]
kexec命令 – 直接起动另一linux内核--->kexec命令的功能是可以从当前正在运行的内核直接引导到一个新内核。 kexec命令跳过了整个引导装载程序阶段 […]
slabtop命令 – 实时显示内核slab缓冲信息--->slabtop命令的命令是以实时的方式显示内核“slab”缓冲区的细节信息。 linux内核需要为临时对象如任 […]
lsmod命令 – 显示已加载模块状态--->lsmod命令用于显示已经加载到内核中的模块的状态信息。 执行lsmod命令后会列出所有已载入系统的模块。li […]
xhost命令 – X服务器访问控制工具--->xhost命令来自英文词组”X-Windows host“的缩写，其功能是X服务器访问控制工具，运行xhost […]
nstat命令 – 监视内核的SNMP计数器和网络接口状态--->nstat是一个简单的监视内核的SNMP计数器和网络接口状态的实用工具 。 语法格式：nstat [参数] 常 […]
swatch命令 – 用于系统监控--->swatch可用来监控系统记录文件，并在发现特定的事件时，执行指定的动作。使用之前需要预设swatch的配置文 […]
SVGATextMode命令 – 加强文字模式的显示画面--->SVGATextMode可用来设置文字模式下的显示画面，包括分辨率，字体和更新频率等。 语法格式：SVGATe […]
mkkickstart命令 – 建立安装的组态文件--->mkkickstart命令用于建立安装的组态文件。可根据目前系统的设置来建立组态文件，供其他电脑在安装时使用。 […]
systemctl命令 – 管理系统服务--->systemctl命令来自英文词组“system control”的缩写，其功能是用于管理系统服务。从RHEL […]
passwd命令 – 修改用户的密码值--->passwd命令来自英文单词“password”的缩写，其功能适用于修改用户的密码值。同时也可以对用户进行锁定 […]
tty命令 – 打印输出连接到标准输入的终端文件名--->tty是 Teletype（电传打字机）的缩写，电传打字机是最早出现的一种终端设备，现在通常使用 TTY 来统 […]
lua命令 – 独立的Lua解释器--->Lua是一门强大，高效，轻量级的嵌入式脚本语言。lua命令是独立的Lua解释器。它能能够加载并执行Lua源程序 […]
procinfo命令 – 显示系统状态--->proc文件系统是一个虚拟文件系统，其中包含存储有关进程和其他系统信息的信息的文件。 它被映射到/proc目录 […]
mpstat命令 – 显示变化的CPU数据--->mpstat命令可以显示随着时间变化的CPU数据，方便找出CPU使用率与时间的关系。这个命令包含在工具集sys […]
chcon命令 – 修改文件的安全上下文--->chcon命令是修改对象（文件）的安全上下文，比如：用户、角色、类型、安全级别。也就是将每个文件的安全环境变更 […]
pwunconv命令 – 关闭投影密码--->pwunconv命令与pwconv功能相反，用来关闭用户的投影密码。它会把密码从shadow文件内，重回存到p […]
pathchk命令 – 检查文件中不可移植的部分--->pathchk命令用于检查文件中不可移植的部分。 语法格式: pathchk [参数] 常用参数：﻿ -p 检 […]
lilo命令 – 安装核心载入--->lilo命令用于安装核心载入，开机管理程序。lilo是个Linux系统核心载入程序，同时具备管理开机的功能。单 […]
ntsysv命令 – 设置系统服务--->ntsysv是Red Hat公司遵循GPL规则所开发的程序，它具有互动式操作界面，您可以轻易地利用方向键和空格 […]
strace命令 – 跟踪系统调用信息--->strace命令来自英文单词“跟踪”，其功能是用于跟踪系统调用信息。strace命令是一个集诊断、调试、统计于 […]
vmstat命令 – 监视系统资源状态--->vmstat命令来自英文词组“Virtual Memory Statistics”的缩写，其功能是用于监视系统 […]
lsof命令 – 查看文件的进程信息--->lsof命令来自于英文词组“list opened files”的缩写，其功能是用于查看文件的进程信息。既然L […]
unalias命令 – 取消命令别名--->unalias命令用来取消命令别名，是为shell内建命令。如果需要取消任意一个命令别名，则使用该命令别名作为 […]
bg命令 – 将作业放到后台运行--->bg命令来自英文单词“background”的缩写，中文译为“背景、后台”，其功能是用于将作业放到后台运行。在 […]
fg命令 – 将作业放到前台运行--->fg命令来自英文单词“foreground”，中文译为“前景”，其功能是用于将作业放到前台运行。在Linux系 […]
exec命令 – 调用并执行指定的命令--->exec命令来自英文单词execute的缩写，其功能是用于调用并执行指定的命令，亦可将前一个命令的输出结果作为 […]
mountpoint命令 –  判断目录是否为挂载点--->mountpoint命令来自英文词组“mount point”的拼写，其功能是用于判断目录是否为挂载点。Lin […]
resize2fs命令 – 同步文件系统容量到内核--->resize2fs命令来自英文词组“resize to filesystem”的缩写，其功能是用于同步文件系统 […]
modinfo命令 – 显示kernel模块的信息--->modinfo命令用于显示kernel模块的信息。 语法格式：modinfo [参数] [模块文件] 常用参数 […]
ulimit命令 – 限制使用系统资源--->ulimit命令来自英文词组“user limit”的缩写，是一条bash解释器的内部命令，其功能是用于限制使 […]
rpm命令 – RPM软件包管理器--->rpm命令来自英文词组“redhat package manager”的缩写，中文译为“红帽软件包管理器”，其 […]
find命令 – 根据路径和条件搜索指定文件--->find命令的功能是用于根据给定的路径和条件查找相关文件或目录，参数灵活方便，且支持正则表达式，结合管道符后能 […]
crontab命令 – 管理定时计划任务--->crontab命令来自英文词组“cron table”的缩写，其功能是管理定时计划任务。定时计划任务，顾名意思 […]
reboot命令 – 重新启动计算机--->reboot命令的功能是用于重新启动计算机。与halt和shutdown命令相似，reboot命令的作用就是用 […]
groupmod命令 – 更改群组属性--->groupmod命令来自英文词组“group modify”的缩写，其功能是用于更改群组属性。Linux系统中 […]
sleep命令 – 延迟当前命令的执行--->sleep命令的功能是用于延迟当前命令的执行，达到所设置的时间后才会执行后续工作。 语法格式：sleep [参 […]
adduser命令 – 创建用户账户--->adduser命令来自英文词组“add user”的缩写，其功能是用于创建用户账户。adduser实际并不是一 […]
groupadd命令 – 创建新的用户组--->groupadd命令来自英文词组“group add”，其功能是用于创建新的用户组。每个用户在创建时都有一个与 […]
groupdel命令 – 删除用户组--->groupdel命令来自英文词组“delete a group”的缩写，其功能是用于删除用户组。Linux系统 […]
hostnamectl命令 – 显示与设置主机名称--->hostnamectl命令来自于英文词组“hostname control”的缩写，其功能是用于显示与设置主机 […]
gpasswd命令 – 设置管理用户组--->gpasswd命令来自英文词组“group password”的缩写，其功能是用于设置管理用户组。用户可以使用 […]
finger命令 –  查询其他使用者的资料--->finger命令的功能是用于查询其他使用者的资料，包含本机现在所有用户的登录信息、账户名称、真实名字、登录终端 […]
fwhois命令 – 查找并显示用户信息--->fwhois的功能有点类似finger指令，它会去查找并显示指定帐号的用户相关信息。不同之处在于fwhois指 […]
suspend命令 – 暂停执行shell--->suspend是终端的内建命令，可暂停目前正在执行的shell。若要恢复，则必须使用SIGCONT信息。 语法 […]
login命令 – 登入系统--->login指令让用户登入系统，您亦可通过它的功能随时更换登入身份。在Slackware发行版中 ，您可在指令后 […]
logname命令 – 显示用户名称--->执行logname指令，它会显示目前用户的名称。 语法格式：logname [参数] 常用参数： –help […]
logout命令 – 退出系统--->logout指令让用户退出系统，其功能和login指令相互对应。 语法格式：logout [参数] 常用参数： […]
chage命令 – 设置账户密码有效期--->chage命令来自英文单词“change”的缩写，其功能是用于设置账号密码有效期。Linux系统管理员都有个不 […]
dircolors命令 – 设置 ls 指令在显示目录或文件时所用的色彩--->dircolors可根据色彩配置文件来设置LS_COLORS环境变量或是显示设置LS_COLORS环境变量的s […]
sliplogin命令 – 将SLIP接口加入标准输入--->sliplogin可将SLIP接口加入标准输入，把一般终端机的连线变成SLIP连线。通常可用来建立SLIP服务 […]
reset命令 – 设定终端机的状态--->Linux reset命令其实和 tset 是一同个命令，它的用途是设定终端机的状态。一般而言，这个命令会自动 […]
logrotate命令 – 管理记录文件--->使用logrotate指令，可以让你轻松管理系统所产生的记录文件。它提供自动替换，压缩，删除和邮寄记录文件，每 […]
clear命令 – 清除终端界面已有内容--->clear命令来自英文单词，中文译为“清理”，其功能是用于清除终端界面已有内容。执行clear命令后终端界面会 […]
bind命令 – 显示或设置键盘按键与其相关的功能--->您可以利用bind命令了解有哪些按键组合与其功能，也可以自行指定要用哪些按键组合。 语法格式：bind [参数 […]
rsh命令 – 远端登入的shell--->rsh命令的英文全称为“remote shell”，该命令提供的用户环境，也就是shell，以便指令能够在指定 […]
rwho命令 – 查看系统用户--->rwho指令的效果类似who指令，但它会显示局域网里所有主机的用户。主机必须提供rwhod常驻服务的功能，方可 […]
vlock命令 – 锁住虚拟终端--->vlock命令的英文全称为“virtual console lock”，该命令可锁住虚拟终端，避免他人使用。  […]
whoami命令 – 显示当前用户名--->whoami命令来自于英文词组”Who am i“的拼写，中文译为”我是谁“，其功能是用于显示当前用户名。wh […]
firewall-cmd命令 – 防火墙策略管理工具--->firewall-cmd命令的功能是用于防火墙策略管理，是firewalld服务的配置工具。使用firewal […]
killall命令 – 基于服务名关闭一组进程--->killall命令来自英文词组“Kill all”的拼写，其功能是用于基于服务名关闭一组进程。我们常使用kil […]
uptime命令 – 查看系统负载--->uptime命令的功能是用于查看系统负载，Linux系统中最常用的命令之一。使用uptime命令能够显示系统已 […]
bash命令 – 命令解释器--->bash命令来自英文词组“Bourne shell”的缩写，其功能是命令解释器。bash是绝大多数Linux系 […]
nohup命令 – 后端运行程序--->nohup命令来自英文词组“no hang up”的缩写，其功能是用于后端运行程序。nohup命令可以将程序以 […]
halt命令 – 关闭当前服务器系统--->halt命令的功能是用于关闭当前服务器系统，类似于poweroff与shutdown命令，没有太大差别。 语法 […]
lastb命令 – 列出登入系统失败的用户--->lastb命令用于显示用户错误的登录列表，此指令可以发现系统的登录异常。 单独执行lastb命令，它会读取位于 […]
chpasswd命令 – 批量更新密码--->chpasswd命令是批量更新用户口令的工具，是把一个文件内容重新定向添加到/etc/shadow中。 chp […]
id命令 – 显示用户与用户组信息--->id命令的功能是用于显示用户与用户组信息。UID是指用户身份的唯一识别号码，相当于人类社会的身份证号码，而GI […]
poweroff命令 – 关闭操作系统--->poweroff命令来自英文单词“关机”，其功能是用于关闭操作系统。很多学习者会着迷于对比poweroff、h […]
screen命令 – 多重视窗管理程序--->screen命令来自英文单词“屏幕”，其功能是用于管理终端窗口的多重视窗。所谓的视窗，实际是指Linux系统中 […]
usermod命令 – 修改用户账号信息--->usermod命令来自英文词组“user modify”的缩写，其功能是用于修改用户账号中的各项参数。用户创建 […]
tload命令 – 显示系统负载状况--->tload命令用于显示系统的负载状况。tload命令用ASCII字符简单的以文字模式显示系统负载状态。假设不给 […]
userconf命令 – 设置用户账号--->userconf的命令全称是“user config”，该命令是用户账号设置程序。 userconf实际上为l […]
chgrp命令 – 更改文件所属用户组--->chgrp命令来自英文词组”change group“的缩写，其功能是用于更改文件所属用户组。Linux系统中 […]
apt-get命令 – 管理服务软件--->apt-get命令来自于英文词组“Advanced Package Tool get”的缩写，其功能是用于管理 […]
dpkg命令 – 管理软件安装包--->dpkg命令来自英文词组“Debian package”的缩写，其功能是用于管理软件安装包，在Debian系统 […]
top命令 – 实时显示系统运行状态--->top命令的功能是用于实时显示系统运行状态，包含处理器、内存、服务、进程等重要资源信息。运维工程师们常常会把t […]
dmesg命令 – 显示开机过程信息--->dmesg命令来自英文词组“display message”的缩写，其功能是用于显示开机过程信息。Linux系 […]
du命令 – 查看文件或目录的大小--->du命令来自英文词组“Disk Usage”的缩写，其功能是用于查看文件或目录的大小。人们经常会把df和du命 […]
init命令 – 切换系统运行级别--->init命令来自英文单词“initialize”的缩写，其功能是用于切换系统运行级别。init命令是Linux […]
shutdown命令 – 关闭服务器的系统--->shutdown命令来自英文单词“关闭”，其功能是用于关闭服务器的系统，作用同于poweroff命令。 语法格 […]
pstree命令 – 以树状图形式显示进程信息--->pstree命令来自英文词组“display a tree of processes”的缩写，其功能是用于以树 […]
fbset命令 – 设置景框缓冲区--->fbset命令为“framebuffer set”的简写，该命令可用于设置景框缓冲区的大小，还能调整画面之分辨 […]
sudo命令 – 授权普通用户执行管理员命令--->sudo命令来自英文词组“super user do”的缩写，中文译为“超级用户才能干的事”，其功能是用于授权 […]
date命令 – 显示或设置系统日期与时间--->date命令来自英文单词“时间、时钟”，其功能是用于显示或设置系统日期与时间信息。运维人员可以根据想要的格式来 […]
help命令 – 显示帮助信息--->help命令的功能是用于显示帮助信息，能够输出Shell内部命令的帮助内容，但对于外部命令则无法使用，需要用m […]
kill命令 – 杀死进程--->kill命令的功能是用于杀死（结束）进程，与英文单词的含义相同。Linux系统中如需结束某个进程，既可以使用如 […]
useradd命令 – 创建并设置用户信息--->useradd命令来自英文词组“User add”的全拼，其功能是用于创建并设置用户信息。使用useradd命 […]
watch命令 – 周期性执行任务命令--->watch命令来自英文单词“观察、监视”，其功能是用于周期性执行任务命令。watch命令会以周期性的方式执行指 […]
w命令 – 显示已登录用户的信息--->w命令来自英文单词“who”的缩写，其功能是用于显示已登录用户的信息。运维人员只需要在命令终端中敲下w键并回车 […]
ps命令 – 显示进程状态--->ps命令来自英文单词“process”的缩写，中文译为“进程”，其功能是用于显示当前系统的进程状态。使用ps命 […]
cal命令 – 显示系统月历与日期--->cal命令来自英文单词“Calendar”的缩写，中文译为“日历”，其功能是用于显示系统月历与日期信息。简单好 […]
exit命令 – 退出终端--->exit命令的功能是用于退出终端。在终端或SHELL脚本中执行exit命令默认会直接退出终端，亦可添加状态值参 […]
yes命令 – 重复打印字符串--->yes命令的作用是中输出指定的字符串，直到yes进程被杀死。不带任何参数输的yes命令默认的字符串就是y。 终 […]
who命令 – 查看当前登录用户信息--->who命令的功能是用于显示当前登录用户信息，包含登录的用户名、终端、日期时间、进程等信息，帮助运维人员了解当前 […]
lastlog命令 –  显示用户最近一次登录信息--->lastlog文件在每次有用户登录时被查询。可以使用lastlog命令检查某特定用户上次登录的时间，并格式化输 […]
uname命令 – 显示系统内核信息--->uname命令来自英文词组“Unix name”的缩写，其功能是用于查看系统主机名、内核及硬件架构等信息。如果 […]